Player,Salario,Pos,Age,Tm,G,GS,MP,FG,FGA,FG%,3P,3PA,3P%,2P,2PA,2P%,eFG%,FT,FTA,FT%,ORB,DRB,TRB,AST,STL,BLK,TOV,PF,PTS
DeMar DeRozan,27739975,AL,30,SAS,68,68,2316,557,1049,0.531,9,35,0.257,548,1014,0.54,0.535,381,451,0.845,44,331,375,380,70,20,164,180,1504
LaMarcus Aldridge,26000000,P,34,SAS,53,53,1754,391,793,0.493,61,157,0.389,330,636,0.519,0.532,158,191,0.827,103,289,392,129,36,87,74,128,1001
Rudy Gay,14000000,AP,33,SAS,67,5,1461,266,596,0.446,74,220,0.336,192,376,0.511,0.508,120,136,0.882,61,301,362,114,35,33,88,103,726
Patty Mills,12428571,BA,31,SAS,66,1,1485,258,598,0.431,154,403,0.382,104,195,0.533,0.56,97,112,0.866,22,86,108,118,53,6,54,105,767
Marco Belinelli,5846154,ES,33,SAS,57,0,883,123,314,0.392,67,178,0.376,56,136,0.412,0.498,48,58,0.828,7,92,99,69,12,1,19,45,361
Trey Lyles,5500000,AP,24,SAS,63,53,1271,153,343,0.446,65,168,0.387,88,175,0.503,0.541,33,45,0.733,71,290,361,69,28,28,39,98,404
Bryn Forbes,2875000,ES,26,SAS,63,62,1579,242,581,0.417,148,381,0.388,94,200,0.47,0.544,75,90,0.833,12,114,126,108,33,0,57,113,707
Luka Šamanić,2689920,AP,20,SAS,3,1,48,5,16,0.313,3,8,0.375,2,8,0.25,0.406,3,4,0.75,1,9,10,6,0,2,2,6,16
Dejounte Murray,2321735,BA,23,SAS,66,58,1687,294,637,0.462,41,111,0.369,253,526,0.481,0.494,91,114,0.798,69,314,383,271,111,17,125,143,720
Keldon Johnson,1950600,AL,20,SAS,17,1,301,53,89,0.596,13,22,0.591,40,67,0.597,0.669,35,44,0.795,10,47,57,15,14,2,13,28,154
Derrick White,1948080,ES,25,SAS,68,20,1677,253,552,0.458,79,216,0.366,174,336,0.518,0.53,180,211,0.853,35,188,223,241,44,59,89,152,765
Chimezie Metu,1416852,P,22,SAS,18,0,105,24,42,0.571,0,2,0.0,24,40,0.6,0.571,10,13,0.769,12,21,33,10,3,6,10,7,58
Russell Westbrook,38506482,BA,31,HOU,57,57,2049,604,1281,0.472,55,213,0.258,549,1068,0.514,0.493,290,380,0.763,100,351,451,401,93,20,255,200,1553
James Harden,38199000,ES,30,HOU,68,68,2483,672,1514,0.444,299,843,0.355,373,671,0.556,0.543,692,800,0.865,70,376,446,512,125,60,308,227,2335
Eric Gordon,14057730,AL,31,HOU,36,15,1016,171,463,0.369,96,303,0.317,75,160,0.469,0.473,82,107,0.766,9,62,71,54,23,13,43,70,520
Robert Covington,11301219,P,29,TOT,70,68,2137,305,723,0.422,161,480,0.335,144,243,0.593,0.533,99,124,0.798,63,400,463,88,115,93,103,220,870
P.J. Tucker,8349039,AP,34,HOU,72,72,2467,177,426,0.415,107,299,0.358,70,127,0.551,0.541,39,48,0.813,112,364,476,115,77,36,72,229,500
Thabo Sefolosha,2564753,AP,35,HOU,41,0,436,37,91,0.407,15,54,0.278,22,37,0.595,0.489,3,8,0.375,21,72,93,25,24,12,15,43,92
Austin Rivers,2174318,ES,27,HOU,68,4,1594,211,501,0.421,96,270,0.356,115,231,0.498,0.517,78,111,0.703,27,148,175,113,49,10,50,129,596
Ben McLemore,2028594,AL,26,HOU,71,23,1619,242,545,0.444,181,452,0.4,61,93,0.656,0.61,50,67,0.746,21,136,157,58,45,16,50,155,715
Bruno Caboclo,1845301,P,24,TOT,30,0,244,38,89,0.427,6,33,0.182,32,56,0.571,0.461,8,9,0.889,23,37,60,12,15,17,13,31,90
Isaiah Hartenstein,1416852,P,21,HOU,23,2,266,44,67,0.657,0,5,0.0,44,62,0.71,0.657,19,28,0.679,29,61,90,18,9,12,16,41,107
David Nwaba,903111,AL,27,BRK,20,0,268,37,71,0.521,12,28,0.429,25,43,0.581,0.606,18,27,0.667,8,37,45,8,11,12,8,32,104
David Nwaba,1678854,AL,27,BRK,20,0,268,37,71,0.521,12,28,0.429,25,43,0.581,0.606,18,27,0.667,8,37,45,8,11,12,8,32,104
Jeff Green,840427,P,33,TOT,48,4,960,159,344,0.462,62,183,0.339,97,161,0.602,0.552,73,91,0.802,24,109,133,50,26,19,42,89,453
Jeff Green,2564753,P,33,TOT,48,4,960,159,344,0.462,62,183,0.339,97,161,0.602,0.552,73,91,0.802,24,109,133,50,26,19,42,89,453
Gary Clark,708426,AP,25,TOT,42,5,567,54,133,0.406,39,111,0.351,15,22,0.682,0.553,9,10,0.9,37,73,110,17,6,22,10,46,156
Gary Clark,718765,AP,25,TOT,42,5,567,54,133,0.406,39,111,0.351,15,22,0.682,0.553,9,10,0.9,37,73,110,17,6,22,10,46,156
Chris Clemons,563347,ES,22,HOU,33,0,291,57,142,0.401,37,107,0.346,20,35,0.571,0.532,10,11,0.909,4,26,30,27,9,6,19,26,161
Luc Mbah a Moute,289803,AP,33,HOU,3,0,25,2,5,0.4,0,2,0.0,2,3,0.667,0.4,1,2,0.5,1,1,2,0,2,0,1,0,5
Damian Lillard,29802321,BA,29,POR,66,66,2474,624,1349,0.463,270,674,0.401,354,675,0.524,0.563,460,518,0.888,33,251,284,530,70,22,194,114,1978
CJ McCollum,27556959,ES,28,POR,70,70,2556,611,1356,0.451,194,512,0.379,417,844,0.494,0.522,140,185,0.757,46,251,297,310,54,42,127,183,1556
Hassan Whiteside,27093018,P,30,POR,67,61,2008,436,702,0.621,4,7,0.571,432,695,0.622,0.624,164,239,0.686,258,647,905,78,26,196,120,196,1040
Trevor Ariza,12200000,AL,34,TOT,53,21,1493,142,324,0.438,77,207,0.372,65,117,0.556,0.557,62,74,0.838,34,212,246,91,69,15,56,111,423
Jusuf Nurkić,12000000,P,25,POR,8,8,253,54,109,0.495,2,10,0.2,52,99,0.525,0.505,31,35,0.886,23,59,82,32,11,16,19,39,141
Rodney Hood,5718000,AL,27,POR,21,21,619,87,172,0.506,35,71,0.493,52,101,0.515,0.608,21,27,0.778,10,62,72,32,17,4,19,46,230
Zach Collins,4240200,AP,22,POR,11,11,290,32,68,0.471,7,19,0.368,25,49,0.51,0.522,6,8,0.75,25,44,69,16,5,5,14,36,77
Carmelo Anthony,2159029,AP,35,POR,58,58,1902,336,782,0.43,87,226,0.385,249,556,0.448,0.485,136,161,0.845,71,297,368,85,49,27,100,171,895
Anfernee Simons,2149560,ES,20,POR,70,4,1449,214,536,0.399,75,226,0.332,139,310,0.448,0.469,76,92,0.826,25,127,152,97,26,10,61,135,579
Nassir Little,2105520,AP,19,POR,48,5,573,65,151,0.43,14,59,0.237,51,92,0.554,0.477,28,44,0.636,31,77,108,22,13,14,15,72,172
Caleb Swanigan,2033160,P,22,TOT,27,1,288,28,47,0.596,0,2,0.0,28,45,0.622,0.596,9,17,0.529,27,73,100,31,3,7,37,62,65
Mario Hezonja,1737145,AP,24,POR,53,4,871,92,218,0.422,24,78,0.308,68,140,0.486,0.477,48,59,0.814,30,154,184,50,36,9,42,107,256
Wenyen Gabriel,1445697,AP,22,TOT,30,1,235,21,48,0.438,6,20,0.3,15,28,0.536,0.5,15,22,0.682,21,31,52,8,11,7,16,39,63
Mike Conley,32511623,BA,32,UTA,47,41,1363,232,567,0.409,96,256,0.375,136,311,0.437,0.494,115,139,0.827,33,118,151,208,36,5,92,104,675
Bojan Bogdanović,17000000,AL,30,UTA,63,63,2083,418,935,0.447,189,457,0.414,229,478,0.479,0.548,250,277,0.903,39,220,259,131,34,7,159,110,1275
Jordan Clarkson,13437500,ES,27,TOT,71,2,1705,394,867,0.454,152,413,0.368,242,454,0.533,0.542,138,165,0.836,50,137,187,136,46,16,97,108,1078
Joe Ingles,11207387,AP,32,UTA,72,45,2137,246,553,0.445,141,353,0.399,105,200,0.525,0.572,74,94,0.787,27,251,278,373,65,11,142,154,707
Donovan Mitchell,3635760,ES,23,UTA,69,69,2364,602,1342,0.449,173,473,0.366,429,869,0.494,0.513,278,322,0.863,53,251,304,294,70,14,184,172,1655
Tony Bradley,1962360,P,22,UTA,58,3,663,126,189,0.667,3,3,1.0,123,186,0.661,0.675,30,46,0.652,111,156,267,23,14,33,30,115,285
Emmanuel Mudiay,1737145,BA,23,UTA,54,2,850,151,327,0.462,30,87,0.345,121,240,0.504,0.508,63,83,0.759,18,108,126,116,24,10,76,72,395
Georges Niang,1678854,AP,26,UTA,66,1,923,141,322,0.438,90,225,0.4,51,97,0.526,0.578,20,24,0.833,15,112,127,44,18,5,30,75,392
Royce O'Neale,1618520,AL,26,UTA,71,62,2049,158,365,0.433,92,244,0.377,66,121,0.545,0.559,42,55,0.764,27,362,389,180,59,32,61,202,450
Nigel Williams-Goss,1500000,BA,25,UTA,10,0,50,5,16,0.313,2,7,0.286,3,9,0.333,0.375,2,2,1.0,2,4,6,6,3,1,3,6,14
Miye Oni,842166,AL,22,UTA,10,1,109,12,32,0.375,7,19,0.368,5,13,0.385,0.484,4,5,0.8,5,12,17,4,4,2,4,9,35
Juwan Morgan,746054,AP,22,UTA,21,0,134,15,26,0.577,3,8,0.375,12,18,0.667,0.635,3,4,0.75,10,19,29,6,1,2,6,19,36
Rayjon Tucker,578573,ES,22,UTA,20,0,161,20,43,0.465,3,17,0.176,17,26,0.654,0.5,19,23,0.826,3,17,20,5,1,1,8,10,62
Kristaps Porziņģis,27285000,P,24,DAL,57,57,1814,398,932,0.427,142,403,0.352,256,529,0.484,0.503,226,283,0.799,100,440,540,102,41,115,92,185,1164
Courtney Lee,12759670,ES,34,DAL,24,9,345,40,82,0.488,21,47,0.447,19,35,0.543,0.616,6,7,0.857,7,25,32,12,18,6,11,33,107
Dwight Powell,10259375,P,28,DAL,40,37,1061,146,229,0.638,10,39,0.256,136,190,0.716,0.659,74,111,0.667,75,152,227,59,34,22,36,102,376
Delon Wright,9473684,BA,27,DAL,73,5,1570,190,411,0.462,47,127,0.37,143,284,0.504,0.519,77,100,0.77,70,210,280,244,85,22,73,93,504
Maxi Kleber,8000000,AP,28,DAL,74,21,1890,237,514,0.461,119,319,0.373,118,195,0.605,0.577,79,93,0.849,112,276,388,88,25,83,58,176,672
Luka Dončić,7683360,BA,20,DAL,61,61,2047,581,1255,0.463,171,541,0.316,410,714,0.574,0.531,426,562,0.758,78,495,573,538,62,14,260,153,1759
Seth Curry,7461380,ES,29,DAL,64,25,1576,284,574,0.495,145,321,0.452,139,253,0.549,0.621,80,97,0.825,27,118,145,124,38,9,62,113,793
Dorian Finney-Smith,4000000,AP,26,DAL,71,68,2120,243,522,0.466,114,303,0.376,129,219,0.589,0.575,78,108,0.722,145,260,405,114,45,39,69,178,678
Boban Marjanović,3500000,P,31,DAL,44,5,422,121,211,0.573,4,17,0.235,117,194,0.603,0.583,43,57,0.754,66,131,197,20,8,10,30,56,289
Justin Jackson,3280920,AP,24,DAL,65,3,1045,135,341,0.396,48,163,0.294,87,178,0.489,0.466,42,50,0.84,27,127,154,52,15,10,14,69,360
J.J. Barea,2564753,BA,35,DAL,29,6,450,85,207,0.411,32,85,0.376,53,122,0.434,0.488,20,22,0.909,10,43,53,112,5,2,38,27,222
Willie Cauley-Stein,2177483,P,26,TOT,54,39,1097,175,302,0.579,0,1,0.0,175,301,0.581,0.579,40,66,0.606,84,231,315,70,49,61,40,121,390
Jalen Brunson,1416852,BA,23,DAL,57,16,1022,181,388,0.466,43,120,0.358,138,268,0.515,0.522,61,75,0.813,22,112,134,188,22,4,66,74,466
Ryan Broekhoff,1416852,AL,29,DAL,17,1,180,22,59,0.373,20,51,0.392,2,8,0.25,0.542,7,8,0.875,5,38,43,11,5,4,6,15,71
Michael Kidd-Gilchrist,810763,AP,26,TOT,25,0,281,22,66,0.333,5,20,0.25,17,46,0.37,0.371,11,14,0.786,14,53,67,14,2,6,16,37,60
Michael Kidd-Gilchrist,12189237,AP,26,TOT,25,0,281,22,66,0.333,5,20,0.25,17,46,0.37,0.371,11,14,0.786,14,53,67,14,2,6,16,37,60
Trey Burke,229220,BA,27,TOT,33,1,520,94,209,0.45,32,75,0.427,62,134,0.463,0.526,23,29,0.793,16,34,50,83,16,2,21,33,243
Trey Burke,2028594,BA,27,TOT,33,1,520,94,209,0.45,32,75,0.427,62,134,0.463,0.526,23,29,0.793,16,34,50,83,16,2,21,33,243
Jrue Holiday,26131111,ES,29,NOP,61,61,2117,458,1006,0.455,122,346,0.353,336,660,0.509,0.516,129,182,0.709,77,216,293,408,99,48,184,145,1167
Derrick Favors,17650000,P,28,NOP,51,49,1243,209,339,0.617,1,7,0.143,208,332,0.627,0.618,40,71,0.563,163,338,501,81,30,46,55,107,459
Zion Williamson,9757440,AP,19,NOP,24,24,668,210,360,0.583,6,14,0.429,204,346,0.59,0.592,114,178,0.64,64,86,150,50,16,9,59,42,540
Lonzo Ball,8719320,BA,22,NOP,63,54,2025,277,687,0.403,148,395,0.375,129,292,0.442,0.511,43,76,0.566,71,312,383,438,88,38,193,128,745
E'Twaun Moore,8664928,ES,30,NOP,56,6,1020,186,437,0.426,63,167,0.377,123,270,0.456,0.498,31,45,0.689,31,100,131,78,32,11,40,80,466
Brandon Ingram,7265485,AP,22,NOP,62,62,2104,507,1096,0.463,150,384,0.391,357,712,0.501,0.531,313,368,0.851,51,329,380,259,61,38,189,179,1477
Jaxson Hayes,4862040,P,19,NOP,64,14,1080,174,259,0.672,1,4,0.25,173,255,0.678,0.674,123,190,0.647,97,162,259,56,26,55,53,161,472
Nicolò Melli,4102564,P,29,NOP,60,8,1042,136,323,0.421,69,206,0.335,67,117,0.573,0.528,54,73,0.74,38,142,180,82,34,23,46,124,395
Nickeil Alexander-Walker,2964840,ES,21,NOP,47,1,591,98,266,0.368,46,133,0.346,52,133,0.391,0.455,25,37,0.676,9,75,84,89,17,8,54,57,267
Josh Hart,1934160,AL,24,NOP,65,16,1755,225,532,0.423,121,354,0.342,104,178,0.584,0.537,85,115,0.739,61,364,425,108,63,23,75,160,656
Jahlil Okafor,1702486,P,24,NOP,30,9,467,101,162,0.623,1,3,0.333,100,159,0.629,0.627,40,62,0.645,48,79,127,37,7,22,38,67,243
Frank Jackson,1618520,BA,21,NOP,59,2,797,134,331,0.405,47,144,0.326,87,187,0.465,0.476,56,75,0.747,22,61,83,61,17,4,49,77,371
Kenrich Williams,1416852,AP,25,NOP,39,18,832,51,147,0.347,25,97,0.258,26,50,0.52,0.432,9,26,0.346,51,135,186,57,27,21,22,88,136
Sindarius Thornwell,183115,AL,25,NOP,2,0,35,6,11,0.545,2,4,0.5,4,7,0.571,0.636,2,4,0.5,0,4,4,4,1,1,2,2,16
Chris Paul,38506482,BA,34,OKC,70,70,2208,434,887,0.489,111,304,0.365,323,583,0.554,0.552,253,279,0.907,26,323,349,472,111,11,161,158,1232
Steven Adams,25842697,P,26,OKC,63,63,1680,283,478,0.592,1,3,0.333,282,475,0.594,0.593,117,201,0.582,207,376,583,146,51,67,94,122,684
Danilo Gallinari,22615559,AP,31,OKC,62,62,1834,358,817,0.438,178,439,0.405,180,378,0.476,0.547,266,298,0.893,34,288,322,119,42,5,76,75,1160
Dennis Schröder,15500000,BA,26,OKC,65,2,1999,453,965,0.469,125,325,0.385,328,640,0.513,0.534,198,236,0.839,19,217,236,262,45,14,166,146,1229
Andre Roberson,10740741,AL,28,OKC,7,0,87,8,29,0.276,3,14,0.214,5,15,0.333,0.328,1,2,0.5,7,20,27,4,1,3,2,13,20
Shai Gilgeous-Alexander,3952920,ES,21,OKC,70,70,2428,478,1015,0.471,87,251,0.347,391,764,0.512,0.514,288,357,0.807,47,365,412,232,79,47,134,117,1331
Terrance Ferguson,2475840,AL,21,OKC,56,38,1257,78,220,0.355,49,168,0.292,29,52,0.558,0.466,15,20,0.75,23,51,74,51,27,17,31,155,220
Darius Bazley,2284800,AP,19,OKC,61,9,1130,125,317,0.394,49,141,0.348,76,176,0.432,0.472,43,62,0.694,30,216,246,41,23,41,45,55,342
Mike Muscala,2028594,P,28,OKC,47,2,572,77,189,0.407,54,143,0.378,23,46,0.5,0.55,18,22,0.818,16,92,108,40,9,12,17,58,226
Nerlens Noel,2028594,P,25,OKC,61,7,1127,184,269,0.684,1,3,0.333,183,266,0.688,0.686,80,106,0.755,91,209,300,57,59,91,66,166,449
Abdel Nader,1618520,AL,26,OKC,55,6,867,123,263,0.468,48,128,0.375,75,135,0.556,0.559,51,66,0.773,14,86,100,38,23,20,43,78,345
Deonte Burton,1416852,AL,26,OKC,39,0,356,43,125,0.344,10,53,0.189,33,72,0.458,0.384,8,14,0.571,7,50,57,17,7,10,19,34,104
Hamidou Diallo,1416852,AL,21,OKC,46,3,896,132,296,0.446,16,57,0.281,116,239,0.485,0.473,38,63,0.603,44,123,167,36,37,9,51,101,318
Patrick Patterson,737067,AP,30,LAC,59,18,776,95,233,0.408,67,172,0.39,28,61,0.459,0.552,35,43,0.814,35,116,151,41,7,3,21,54,292
Patrick Patterson,2331593,AP,30,LAC,59,18,776,95,233,0.408,67,172,0.39,28,61,0.459,0.552,35,43,0.814,35,116,151,41,7,3,21,54,292
Luguentz Dort,155647,AL,20,OKC,36,28,820,86,218,0.394,30,101,0.297,56,117,0.479,0.463,42,53,0.792,24,57,81,27,31,4,22,97,244
Karl-Anthony Towns,27285000,P,24,MIN,35,35,1187,316,622,0.508,114,277,0.412,202,345,0.586,0.6,180,226,0.796,95,283,378,153,33,42,110,117,926
D'Angelo Russell,27285000,BA,23,TOT,45,45,1452,360,846,0.426,158,431,0.367,202,415,0.487,0.519,161,199,0.809,17,160,177,285,48,13,147,86,1039
Evan Turner,18606557,ES,31,ATL,19,0,251,25,67,0.373,0,5,0.0,25,62,0.403,0.373,12,14,0.857,8,30,38,38,9,8,26,20,62
Allen Crabbe,17818456,AL,27,TOT,37,1,653,63,177,0.356,36,119,0.303,27,58,0.466,0.458,10,14,0.714,11,66,77,33,15,4,17,47,172
James Johnson,15349400,P,32,TOT,32,1,619,103,215,0.479,33,91,0.363,70,124,0.565,0.556,31,48,0.646,25,93,118,74,25,32,48,80,270
Jarrett Culver,5813640,ES,20,MIN,63,35,1506,230,569,0.404,66,221,0.299,164,348,0.471,0.462,54,117,0.462,70,142,212,110,57,38,81,125,580
Jake Layman,3581986,AL,25,MIN,23,2,505,81,179,0.453,24,72,0.333,57,107,0.533,0.52,24,32,0.75,17,40,57,15,17,10,24,47,210
Juancho Hernangómez,3321030,AP,24,TOT,48,14,833,100,247,0.405,44,129,0.341,56,118,0.475,0.494,44,71,0.62,43,154,197,40,19,9,32,64,288
Malik Beasley,2731714,ES,23,TOT,55,14,1209,227,534,0.425,107,276,0.388,120,258,0.465,0.525,54,66,0.818,18,130,148,75,40,8,57,77,615
Josh Okogie,2530680,ES,21,MIN,62,28,1547,170,398,0.427,41,154,0.266,129,244,0.529,0.479,152,191,0.796,87,181,268,99,68,26,87,139,533
Jacob Evans,1925880,ES,22,TOT,29,1,418,45,134,0.336,13,39,0.333,32,95,0.337,0.384,25,29,0.862,9,32,41,31,11,12,25,41,128
Omari Spellman,1897800,P,22,GSW,49,3,886,127,295,0.431,43,110,0.391,84,185,0.454,0.503,73,92,0.793,77,142,219,47,33,24,54,63,370
Jarred Vanderbilt,1416852,AP,20,TOT,11,0,46,5,8,0.625,0,1,0.0,5,7,0.714,0.625,2,2,1.0,3,6,9,2,3,1,7,6,12
Jaylen Nowell,1400000,ES,20,MIN,15,0,151,19,53,0.358,3,26,0.115,16,27,0.593,0.387,16,17,0.941,3,10,13,19,3,1,3,11,57
Naz Reid,898310,P,20,MIN,30,11,495,100,243,0.412,32,97,0.33,68,146,0.466,0.477,37,53,0.698,34,90,124,35,19,22,22,83,269
LeBron James,37436858,BA,35,LAL,67,67,2316,643,1303,0.493,148,425,0.348,495,878,0.564,0.55,264,381,0.693,66,459,525,684,78,36,261,118,1698
Anthony Davis,27093019,AP,26,LAL,62,62,2131,551,1096,0.503,72,218,0.33,479,878,0.546,0.536,444,525,0.846,142,435,577,200,91,143,154,156,1618
Danny Green,14634146,ES,32,LAL,68,68,1687,197,474,0.416,120,327,0.367,77,147,0.524,0.542,33,48,0.688,51,174,225,91,85,32,63,136,547
Kentavious Caldwell-Pope,8089282,ES,26,LAL,69,26,1762,237,507,0.467,92,239,0.385,145,268,0.541,0.558,79,102,0.775,38,104,142,111,57,14,62,128,645
Avery Bradley,4767000,ES,29,LAL,49,44,1186,170,383,0.444,63,173,0.364,107,210,0.51,0.526,20,24,0.833,18,97,115,63,43,5,47,110,423
Avery Bradley,2000000,ES,29,LAL,49,44,1186,170,383,0.444,63,173,0.364,107,210,0.51,0.526,20,24,0.833,18,97,115,63,43,5,47,110,423
JaVale McGee,4000000,P,32,LAL,68,68,1130,195,306,0.637,3,6,0.5,192,300,0.64,0.642,53,82,0.646,125,265,390,37,36,94,55,159,446
Quinn Cook,3000000,BA,26,LAL,44,1,508,91,214,0.425,31,85,0.365,60,129,0.465,0.498,11,14,0.786,11,40,51,49,12,2,33,27,224
Alex Caruso,2750000,BA,25,LAL,64,2,1175,120,291,0.412,40,120,0.333,80,171,0.468,0.481,69,94,0.734,17,106,123,124,70,18,53,98,349
Jared Dudley,2564753,AP,34,LAL,45,1,364,24,60,0.4,18,42,0.429,6,18,0.333,0.55,2,2,1.0,6,46,52,28,15,3,8,41,68
Rajon Rondo,2564753,BA,33,LAL,48,3,984,137,328,0.418,41,125,0.328,96,203,0.473,0.48,27,41,0.659,23,119,142,240,40,2,91,58,342
Dwight Howard,2564753,P,34,LAL,69,2,1306,202,277,0.729,3,5,0.6,199,272,0.732,0.735,110,214,0.514,172,335,507,45,31,79,84,222,517
Dwight Howard,3039097,P,34,LAL,69,2,1306,202,277,0.729,3,5,0.6,199,272,0.732,0.735,110,214,0.514,172,335,507,45,31,79,84,222,517
Troy Daniels,2028594,ES,28,TOT,47,0,532,72,186,0.387,46,132,0.348,26,54,0.481,0.511,10,16,0.625,12,40,52,17,11,3,12,37,200
Troy Daniels,481000,ES,28,TOT,47,0,532,72,186,0.387,46,132,0.348,26,54,0.481,0.511,10,16,0.625,12,40,52,17,11,3,12,37,200
Kyle Kuzma,1974600,AP,24,LAL,61,9,1526,291,668,0.436,86,272,0.316,205,396,0.518,0.5,114,155,0.735,52,221,273,80,28,26,91,126,782
Markieff Morris,1750000,AP,30,TOT,58,17,1187,203,458,0.443,88,228,0.386,115,230,0.5,0.539,66,85,0.776,40,178,218,77,31,17,76,133,560
Markieff Morris,2241808,AP,30,TOT,58,17,1187,203,458,0.443,88,228,0.386,115,230,0.5,0.539,66,85,0.776,40,178,218,77,31,17,76,133,560
Talen Horton-Tucker,898310,ES,19,LAL,6,1,81,14,30,0.467,4,13,0.308,10,17,0.588,0.533,2,4,0.5,2,5,7,6,8,1,6,10,34
Dion Waiters,503656,ES,28,TOT,10,0,207,41,99,0.414,15,47,0.319,26,52,0.5,0.49,14,17,0.824,2,22,24,20,4,6,16,21,111
Dion Waiters,12100000,ES,28,TOT,10,0,207,41,99,0.414,15,47,0.319,26,52,0.5,0.49,14,17,0.824,2,22,24,20,4,6,16,21,111
J.R. Smith,289803,ES,34,LAL,6,0,79,7,22,0.318,1,11,0.091,6,11,0.545,0.341,2,2,1.0,0,5,5,3,1,0,4,5,17
J.R. Smith,1456667,ES,34,LAL,6,0,79,7,22,0.318,1,11,0.091,6,11,0.545,0.341,2,2,1.0,0,5,5,3,1,0,4,5,17
Stephen Curry,40231758,BA,31,GSW,5,5,139,33,82,0.402,12,49,0.245,21,33,0.636,0.476,26,26,1.0,4,22,26,33,5,2,16,11,104
Andrew Wiggins,27504630,AL,24,TOT,54,54,1858,437,978,0.447,111,334,0.332,326,644,0.506,0.504,190,268,0.709,66,208,274,198,45,53,132,127,1175
Draymond Green,18539130,AP,29,GSW,43,43,1222,123,316,0.389,36,129,0.279,87,187,0.465,0.446,63,83,0.759,23,243,266,266,59,33,98,110,345
Kevon Looney,4464286,P,23,GSW,20,4,262,29,79,0.367,1,14,0.071,28,65,0.431,0.373,9,12,0.75,28,38,66,20,12,6,12,34,68
Jordan Poole,1964760,ES,20,GSW,57,14,1274,167,502,0.333,74,265,0.279,93,237,0.392,0.406,95,119,0.798,9,109,118,134,35,10,74,94,503
Marquese Chriss,1413272,AP,22,GSW,59,21,1196,210,385,0.545,8,39,0.205,202,346,0.584,0.556,120,156,0.769,114,251,365,114,39,62,78,122,548
Alen Smailagić,898310,P,19,GSW,14,0,139,20,40,0.5,3,13,0.231,17,27,0.63,0.538,16,19,0.842,10,17,27,13,3,4,11,14,59
Eric Paschall,898310,AP,23,GSW,60,26,1654,318,640,0.497,37,129,0.287,281,511,0.55,0.526,164,212,0.774,82,193,275,127,32,13,94,125,837
Damion Lee,842327,ES,27,GSW,49,36,1423,213,511,0.417,85,239,0.356,128,272,0.471,0.5,110,126,0.873,32,207,239,133,50,6,67,116,621
Ky Bowman,350189,BA,22,GSW,45,12,1015,134,321,0.417,33,107,0.308,101,214,0.472,0.469,34,41,0.829,24,97,121,131,44,10,70,102,335
Juan Toscano-Anderson,350189,ES,26,GSW,13,6,272,29,63,0.46,8,23,0.348,21,40,0.525,0.524,3,5,0.6,9,43,52,26,13,5,16,30,69
Mychal Mulder,238534,AL,25,GSW,7,3,204,26,67,0.388,16,52,0.308,10,15,0.667,0.507,9,12,0.75,3,20,23,8,2,1,5,20,77
Dragan Bender,189702,P,22,TOT,16,3,286,41,92,0.446,15,43,0.349,26,49,0.531,0.527,10,14,0.714,16,57,73,28,4,9,21,42,107
Dragan Bender,1678854,P,22,TOT,16,3,286,41,92,0.446,15,43,0.349,26,49,0.531,0.527,10,14,0.714,16,57,73,28,4,9,21,42,107
Chasson Randle,91557,BA,26,GSW,3,0,40,0,4,0.0,0,2,0.0,0,2,0.0,0.0,5,6,0.833,0,2,2,5,2,0,0,3,5
Jeremy Pargo,91557,BA,33,GSW,3,0,44,11,22,0.5,3,7,0.429,8,15,0.533,0.568,0,1,0.0,1,2,3,8,1,0,4,8,25
Zach Norvell,50752,ES,22,TOT,5,0,41,3,12,0.25,3,8,0.375,0,4,0.0,0.375,1,1,1.0,0,6,6,3,2,0,3,4,10
Paul George,33005556,AL,29,LAC,48,48,1419,343,782,0.439,157,381,0.412,186,401,0.464,0.539,190,217,0.876,24,248,272,185,68,20,125,113,1033
Kawhi Leonard,32742000,AL,28,LAC,57,57,1848,532,1133,0.47,123,325,0.378,409,808,0.506,0.524,356,402,0.886,54,348,402,280,103,33,149,113,1543
Marcus Morris,15000000,AP,30,TOT,62,62,1936,355,810,0.438,142,348,0.408,213,462,0.461,0.526,181,220,0.823,59,252,311,86,47,30,97,180,1033
Patrick Beverley,12345679,BA,31,LAC,51,50,1342,147,341,0.431,80,206,0.388,67,135,0.496,0.548,31,47,0.66,57,209,266,183,54,25,66,156,405
Lou Williams,8000000,BA,33,LAC,65,8,1864,391,936,0.418,111,315,0.352,280,621,0.451,0.477,292,339,0.861,31,170,201,365,43,12,182,80,1185
Ivica Zubac,6481482,P,22,LAC,72,70,1326,236,385,0.613,0,2,0.0,236,383,0.616,0.613,124,166,0.747,197,346,543,82,16,66,61,168,596
Montrezl Harrell,6000000,P,26,LAC,63,2,1749,471,812,0.58,0,18,0.0,471,794,0.593,0.58,231,351,0.658,163,282,445,107,39,72,108,146,1173
Rodney McGruder,4807693,ES,28,LAC,56,4,871,72,181,0.398,24,89,0.27,48,92,0.522,0.464,19,34,0.559,29,122,151,36,26,8,24,74,187
JaMychal Green,4767000,AP,29,LAC,63,1,1307,151,352,0.429,92,238,0.387,59,114,0.518,0.56,36,48,0.75,77,311,388,49,29,24,54,174,430
Isaiah Thomas,2320044,BA,30,WAS,40,37,925,174,426,0.408,78,189,0.413,96,237,0.405,0.5,62,76,0.816,11,57,68,146,13,6,77,77,488
Landry Shamet,1995120,ES,22,LAC,53,30,1452,158,391,0.404,111,296,0.375,47,95,0.495,0.546,65,76,0.855,6,94,100,99,20,10,42,142,492
Mfiondu Kabengele,1977000,P,22,LAC,12,0,64,14,32,0.438,9,20,0.45,5,12,0.417,0.578,5,5,1.0,1,10,11,2,2,2,2,9,42
Terance Mann,1000000,AL,23,LAC,41,6,362,37,79,0.468,7,20,0.35,30,59,0.508,0.513,18,27,0.667,10,45,55,53,11,5,18,46,99
Reggie Jackson,734025,BA,29,TOT,31,16,743,134,326,0.411,57,145,0.393,77,181,0.425,0.498,45,54,0.833,17,75,92,126,13,5,51,59,370
Reggie Jackson,17286956,BA,29,TOT,31,16,743,134,326,0.411,57,145,0.393,77,181,0.425,0.498,45,54,0.833,17,75,92,126,13,5,51,59,370
Devin Booker,27285000,ES,23,PHO,70,70,2512,627,1283,0.489,141,398,0.354,486,885,0.549,0.544,468,509,0.919,29,268,297,456,49,18,264,213,1863
Tyler Johnson,19245370,BA,27,TOT,39,7,709,97,250,0.388,38,119,0.319,59,131,0.45,0.464,42,50,0.84,18,58,76,74,16,9,29,58,274
Tyler Johnson,212753,BA,27,TOT,39,7,709,97,250,0.388,38,119,0.319,59,131,0.45,0.464,42,50,0.84,18,58,76,74,16,9,29,58,274
Ricky Rubio,16200000,BA,29,PHO,65,65,2016,287,692,0.415,78,216,0.361,209,476,0.439,0.471,195,226,0.863,46,258,304,570,94,11,173,167,847
Deandre Ayton,9562920,P,21,PHO,38,32,1236,310,568,0.546,3,13,0.231,307,555,0.553,0.548,67,89,0.753,147,289,436,72,26,58,80,117,690
Aron Baynes,5453280,P,33,PHO,42,28,934,183,381,0.48,59,168,0.351,124,213,0.582,0.558,56,75,0.747,71,166,237,67,10,23,50,141,481
Frank Kaminsky,4767000,P,26,PHO,39,13,777,138,307,0.45,41,124,0.331,97,183,0.53,0.516,61,90,0.678,35,141,176,75,14,10,37,75,378
Mikal Bridges,4161000,AL,23,PHO,73,32,2042,247,484,0.51,70,194,0.361,177,290,0.61,0.583,103,122,0.844,66,226,292,129,102,46,73,163,667
Cameron Johnson,4033440,AP,23,PHO,57,9,1255,176,405,0.435,106,272,0.39,70,133,0.526,0.565,46,57,0.807,49,138,187,69,36,20,32,88,504
Dario Šarić,3481986,AP,25,PHO,66,51,1632,256,538,0.476,84,235,0.357,172,303,0.568,0.554,108,128,0.844,100,306,406,123,37,16,88,156,704
Kyle Korver,3440000,AL,38,MIL,58,1,960,126,293,0.43,99,237,0.418,27,56,0.482,0.599,35,41,0.854,15,107,122,68,26,12,48,78,386
Kyle Korver,2564753,AL,38,MIL,58,1,960,126,293,0.43,99,237,0.418,27,56,0.482,0.599,35,41,0.854,15,107,122,68,26,12,48,78,386
Ty Jerome,2193480,ES,22,PHO,31,0,328,38,113,0.336,14,50,0.28,24,63,0.381,0.398,12,16,0.75,7,39,46,44,15,3,18,29,102
Cheick Diallo,1678854,P,23,PHO,47,2,479,92,142,0.648,1,3,0.333,91,139,0.655,0.651,34,39,0.872,30,101,131,22,11,12,32,55,219
Jevon Carter,1416852,BA,24,PHO,58,2,945,101,243,0.416,62,146,0.425,39,97,0.402,0.543,23,27,0.852,30,88,118,84,47,17,32,86,287
Elie Okobo,1416852,BA,22,PHO,55,3,719,72,181,0.398,25,71,0.352,47,110,0.427,0.467,50,71,0.704,16,74,90,115,24,4,38,54,219
Jalen Lecque,898310,ES,19,PHO,5,0,32,4,10,0.4,0,4,0.0,4,6,0.667,0.4,2,2,1.0,0,2,2,2,0,0,2,3,10
Cameron Payne,196288,ES,25,PHO,8,0,183,33,68,0.485,15,29,0.517,18,39,0.462,0.596,6,7,0.857,4,27,31,24,8,2,11,20,87
Cameron Payne,150000,ES,25,PHO,8,0,183,33,68,0.485,15,29,0.517,18,39,0.462,0.596,6,7,0.857,4,27,31,24,8,2,11,20,87
Jonah Bolden,81678,P,24,TOT,7,0,47,4,11,0.364,0,4,0.0,4,7,0.571,0.364,2,4,0.5,3,6,9,0,3,2,2,10,10
Jonah Bolden,1698450,P,24,TOT,7,0,47,4,11,0.364,0,4,0.0,4,7,0.571,0.364,2,4,0.5,3,6,9,0,3,2,2,10,10
Harrison Barnes,24147727,AP,27,SAC,72,72,2482,365,793,0.46,102,268,0.381,263,525,0.501,0.525,214,267,0.801,77,278,355,159,43,12,88,93,1046
Kent Bazemore,19269662,AL,30,TOT,68,21,1688,200,534,0.375,84,244,0.344,116,290,0.4,0.453,113,147,0.769,27,267,294,93,74,40,91,196,597
Cory Joseph,12000000,BA,28,SAC,72,26,1759,171,412,0.415,56,159,0.352,115,253,0.455,0.483,60,70,0.857,44,144,188,251,53,21,80,133,458
Bogdan Bogdanović,8529386,ES,27,SAC,61,28,1766,337,766,0.44,164,441,0.372,173,325,0.532,0.547,86,116,0.741,26,181,207,207,64,15,102,133,924
Nemanja Bjelica,6825000,AP,31,SAC,72,67,2011,314,653,0.481,134,320,0.419,180,333,0.541,0.583,69,84,0.821,111,347,458,203,62,40,99,216,831
Jabari Parker,6500000,AP,24,TOT,38,23,917,219,429,0.51,32,119,0.269,187,310,0.603,0.548,61,81,0.753,61,153,214,68,45,16,64,99,531
De'Aaron Fox,6392760,BA,22,SAC,51,49,1634,391,815,0.48,54,185,0.292,337,630,0.535,0.513,241,342,0.705,35,161,196,348,74,25,158,145,1077
Buddy Hield,4861208,ES,27,SAC,72,44,2216,498,1162,0.429,271,688,0.394,227,474,0.479,0.545,115,136,0.846,57,271,328,213,66,17,168,165,1382
Alex Len,4160000,P,26,TOT,55,12,970,177,319,0.555,16,59,0.271,161,260,0.619,0.58,68,105,0.648,100,221,321,50,23,48,55,127,438
Yogi Ferrell,3150000,BA,26,SAC,50,0,530,79,188,0.42,24,79,0.304,55,109,0.505,0.484,36,42,0.857,6,43,49,69,18,4,28,38,218
Harry Giles,2578800,P,21,SAC,46,17,667,139,251,0.554,0,2,0.0,139,249,0.558,0.554,38,49,0.776,43,145,188,60,22,18,44,119,316
Anthony Tolliver,2419852,AP,34,TOT,55,13,872,65,182,0.357,49,145,0.338,16,37,0.432,0.492,21,29,0.724,34,120,154,42,19,11,34,74,200
Anthony Tolliver,434704,AP,34,TOT,55,13,872,65,182,0.357,49,145,0.338,16,37,0.432,0.492,21,29,0.724,34,120,154,42,19,11,34,74,200
Justin James,898310,AL,23,SAC,36,0,232,35,84,0.417,9,29,0.31,26,55,0.473,0.47,10,21,0.476,6,26,32,18,6,9,8,17,89
Corey Brewer,289803,AP,33,SAC,5,0,33,2,4,0.5,0,1,0.0,2,3,0.667,0.5,1,3,0.333,2,6,8,2,4,0,2,7,5
Gorgui Dieng,16229213,P,30,TOT,63,17,1096,166,364,0.456,54,152,0.355,112,212,0.528,0.53,78,101,0.772,91,263,354,73,51,59,60,124,464
Jonas Valančiūnas,16000000,P,27,MEM,70,70,1845,432,739,0.585,32,91,0.352,400,648,0.617,0.606,148,200,0.74,213,575,788,131,30,76,127,185,1044
Justise Winslow,13000000,ES,23,MIA,11,5,352,50,129,0.388,6,27,0.222,44,102,0.431,0.411,18,27,0.667,16,57,73,44,7,5,24,38,124
Kyle Anderson,9073050,AL,26,MEM,67,28,1330,157,331,0.474,24,85,0.282,133,246,0.541,0.511,52,78,0.667,58,227,285,162,54,37,66,111,390
Ja Morant,8730240,BA,20,MEM,67,67,2074,447,937,0.477,60,179,0.335,387,758,0.511,0.509,239,308,0.776,51,208,259,488,58,18,220,110,1193
Tyus Jones,8400000,BA,23,MEM,65,6,1232,197,429,0.459,47,124,0.379,150,305,0.492,0.514,43,58,0.741,9,94,103,285,59,6,55,44,484
Josh Jackson,7059480,AL,22,MEM,22,0,381,70,159,0.44,23,72,0.319,47,87,0.54,0.513,35,50,0.7,11,55,66,35,18,9,28,40,198
Brandon Clarke,2478840,AP,23,MEM,58,4,1300,296,479,0.618,23,64,0.359,273,415,0.658,0.642,85,112,0.759,92,253,345,81,32,48,55,100,700
Grayson Allen,2277563,ES,24,MEM,38,0,718,117,251,0.466,57,141,0.404,60,110,0.545,0.58,39,45,0.867,8,77,85,52,10,2,33,53,330
Jordan Bell,1620564,P,25,TOT,29,0,256,35,67,0.522,4,12,0.333,31,55,0.564,0.552,19,31,0.613,30,51,81,16,3,10,21,19,93
Jordan Bell,250000,P,25,TOT,29,0,256,35,67,0.522,4,12,0.333,31,55,0.564,0.552,19,31,0.613,30,51,81,16,3,10,21,19,93
Dillon Brooks,1618520,ES,24,MEM,73,73,2112,435,1068,0.407,147,411,0.358,288,657,0.438,0.476,164,203,0.808,68,175,243,150,63,27,124,278,1181
De'Anthony Melton,1416852,BA,21,MEM,60,8,1167,161,401,0.401,40,140,0.286,121,261,0.464,0.451,93,121,0.769,43,177,220,175,77,20,84,109,455
Dusty Hannahs,81678,ES,26,MEM,2,0,13,4,9,0.444,2,3,0.667,2,6,0.333,0.556,2,2,1.0,0,1,1,0,0,0,0,1,12
Jarrod Uthoff,81678,AP,26,TOT,7,0,53,7,18,0.389,3,9,0.333,4,9,0.444,0.472,2,2,1.0,2,4,6,0,1,0,0,2,19
Jarrod Uthoff,163356,AP,26,TOT,7,0,53,7,18,0.389,3,9,0.333,4,9,0.444,0.472,2,2,1.0,2,4,6,0,1,0,0,2,19
Paul Millsap,30500000,AP,34,DEN,51,48,1240,211,438,0.482,54,124,0.435,157,314,0.5,0.543,115,141,0.816,98,195,293,83,44,30,70,150,591
Nikola Jokić,26573595,P,24,DEN,73,73,2336,565,1071,0.528,80,255,0.314,485,816,0.594,0.565,246,301,0.817,166,545,711,512,85,44,226,222,1456
Gary Harris,17839286,ES,25,DEN,56,55,1780,218,519,0.42,70,210,0.333,148,309,0.479,0.487,75,92,0.815,26,137,163,118,76,14,60,116,581
Mason Plumlee,14041096,P,29,DEN,61,1,1057,177,288,0.615,0,5,0.0,177,283,0.625,0.615,83,155,0.535,98,219,317,154,33,38,82,143,437
Will Barton,12776786,AL,29,DEN,58,58,1916,332,738,0.45,108,288,0.375,224,450,0.498,0.523,102,133,0.767,76,289,365,212,61,29,88,121,874
Jerami Grant,9346153,AP,25,DEN,71,24,1892,303,634,0.478,98,252,0.389,205,382,0.537,0.555,147,196,0.75,58,190,248,88,50,57,63,154,851
Jamal Murray,4444746,BA,22,DEN,59,59,1904,408,894,0.456,112,324,0.346,296,570,0.519,0.519,163,185,0.881,45,191,236,284,67,17,127,102,1091
Noah Vonleh,2000000,P,24,TOT,36,1,377,52,92,0.565,3,15,0.2,49,77,0.636,0.582,25,32,0.781,37,87,124,28,11,6,21,40,132
Torrey Craig,2000000,AL,29,DEN,58,27,1072,124,269,0.461,45,138,0.326,79,131,0.603,0.545,22,36,0.611,63,126,189,47,23,36,25,135,315
Monte Morris,1588231,BA,24,DEN,73,12,1636,260,566,0.459,65,172,0.378,195,394,0.495,0.517,75,89,0.843,24,113,137,255,55,17,53,73,660
Keita Bates-Diop,1416852,AP,24,TOT,44,0,744,100,234,0.427,34,103,0.33,66,131,0.504,0.5,54,75,0.72,25,102,127,30,19,24,17,43,288
Vlatko Čančar,898310,AP,22,DEN,14,0,45,6,15,0.4,1,6,0.167,5,9,0.556,0.433,4,4,1.0,5,5,10,3,1,1,3,7,17
PJ Dozier,183115,ES,23,DEN,29,0,412,65,157,0.414,17,49,0.347,48,108,0.444,0.468,21,29,0.724,10,45,55,63,14,6,27,45,168
Blake Griffin,34234964,AP,30,DET,18,18,512,88,250,0.352,27,111,0.243,61,139,0.439,0.406,76,98,0.776,17,67,84,59,7,7,40,27,279
Brandon Knight,15643750,ES,28,TOT,25,3,462,59,167,0.353,45,131,0.344,14,36,0.389,0.488,20,34,0.588,4,37,41,69,10,3,38,40,183
Tony Snell,11392857,AL,28,DET,59,57,1641,170,382,0.445,102,254,0.402,68,128,0.531,0.579,32,32,1.0,9,102,111,127,32,15,31,101,474
John Henson,9732396,P,29,TOT,40,8,600,95,171,0.556,8,36,0.222,87,135,0.644,0.579,23,46,0.5,46,116,162,54,24,42,36,78,221
Langston Galloway,7333333,ES,28,DET,66,6,1702,236,542,0.435,132,331,0.399,104,211,0.493,0.557,73,85,0.859,33,116,149,101,48,11,40,96,677
Derrick Rose,7317073,BA,31,DET,50,15,1298,369,753,0.49,45,147,0.306,324,606,0.535,0.52,121,139,0.871,27,94,121,278,40,16,126,49,904
Luke Kennard,3827160,ES,23,DET,28,25,922,151,342,0.442,73,183,0.399,78,159,0.491,0.548,67,75,0.893,9,89,98,115,12,6,43,65,442
Thon Maker,3569643,P,22,DET,60,14,776,93,193,0.482,22,64,0.344,71,129,0.55,0.539,73,110,0.664,54,113,167,43,25,39,45,102,281
Sekou Doumbouya,3285120,AP,19,DET,38,19,754,92,236,0.39,28,98,0.286,64,138,0.464,0.449,31,46,0.674,20,98,118,19,20,8,35,80,243
Tim Frazier,1882867,BA,29,DET,27,11,355,34,94,0.362,10,30,0.333,24,64,0.375,0.415,19,24,0.792,9,24,33,93,14,4,36,42,97
Christian Wood,1645357,AP,24,DET,62,12,1325,288,508,0.567,54,140,0.386,234,368,0.636,0.62,180,242,0.744,104,286,390,60,34,54,84,98,810
Jordan McRae,1645357,ES,28,TOT,37,4,784,149,366,0.407,45,126,0.357,104,240,0.433,0.469,83,109,0.761,18,106,124,93,21,16,43,73,426
Khyri Thomas,1416852,ES,23,DET,8,0,61,5,17,0.294,5,14,0.357,0,3,0.0,0.441,2,4,0.5,1,0,1,3,3,0,3,9,17
Bruce Brown,1416852,BA,23,DET,58,43,1634,198,447,0.443,33,96,0.344,165,351,0.47,0.48,88,119,0.739,61,213,274,230,63,29,100,162,517
Svi Mykhailiuk,1416852,AL,22,DET,56,27,1265,166,405,0.41,115,285,0.404,51,120,0.425,0.552,57,70,0.814,17,87,104,106,41,4,61,87,504
Derrick Walton,81678,BA,24,TOT,26,1,248,18,39,0.462,10,24,0.417,8,15,0.533,0.59,7,9,0.778,2,14,16,27,7,0,5,21,53
Derrick Walton,1445697,BA,24,TOT,26,1,248,18,39,0.462,10,24,0.417,8,15,0.533,0.59,7,9,0.778,2,14,16,27,7,0,5,21,53
Nicolas Batum,25565217,AL,31,CHO,22,3,505,28,81,0.346,14,49,0.286,14,32,0.438,0.432,9,10,0.9,25,75,100,66,17,8,22,41,79
Terry Rozier,19894737,BA,25,CHO,63,63,2164,398,941,0.423,172,423,0.407,226,518,0.436,0.514,166,190,0.874,50,226,276,259,61,10,141,126,1134
Cody Zeller,14471910,P,27,CHO,58,39,1341,251,479,0.524,18,75,0.24,233,404,0.577,0.543,122,179,0.682,160,251,411,88,40,25,75,140,642
Marvin Williams,14049901,AP,33,TOT,58,1,1129,119,267,0.446,56,156,0.359,63,111,0.568,0.551,49,57,0.86,30,153,183,60,36,30,33,103,343
Marvin Williams,956349,AP,33,TOT,58,1,1129,119,267,0.446,56,156,0.359,63,111,0.568,0.551,49,57,0.86,30,153,183,60,36,30,33,103,343
Malik Monk,4028400,ES,21,CHO,55,1,1169,212,488,0.434,58,204,0.284,154,284,0.542,0.494,82,100,0.82,27,130,157,114,25,16,77,74,564
P.J. Washington,3831840,AP,21,CHO,58,57,1759,268,589,0.455,86,230,0.374,182,359,0.507,0.528,88,136,0.647,58,258,316,123,51,44,93,158,710
Miles Bridges,3755400,AL,21,CHO,65,64,1995,319,753,0.424,99,300,0.33,220,453,0.486,0.489,106,131,0.809,88,274,362,114,40,48,95,132,843
Willy Hernangómez,1676735,P,25,CHO,31,0,375,74,139,0.532,5,22,0.227,69,117,0.59,0.55,37,59,0.627,43,91,134,29,10,7,30,32,190
Dwayne Bacon,1618520,ES,24,CHO,39,11,687,85,244,0.348,19,67,0.284,66,177,0.373,0.387,35,53,0.66,15,85,100,52,23,2,37,52,224
Devonte' Graham,1416852,BA,24,CHO,63,53,2211,368,963,0.382,218,585,0.373,150,378,0.397,0.495,191,233,0.82,42,170,212,471,62,15,181,115,1145
Cody Martin,1173310,AL,24,CHO,48,3,903,89,207,0.43,18,77,0.234,71,130,0.546,0.473,42,65,0.646,38,120,158,95,39,9,44,78,238
Jalen McDaniels,898310,AL,22,CHO,16,0,293,33,70,0.471,9,24,0.375,24,46,0.522,0.536,14,17,0.824,15,50,65,13,8,3,11,36,89
Caleb Martin,842166,AL,24,CHO,18,1,317,37,84,0.44,20,37,0.541,17,47,0.362,0.56,17,21,0.81,10,28,38,23,12,7,15,32,111
Joe Chealey,163356,BA,24,CHO,4,0,33,0,7,0.0,0,4,0.0,0,3,0.0,0.0,2,2,1.0,0,0,0,1,4,0,2,2,2
Nikola Vučević,28000000,P,29,ORL,62,62,1998,493,1033,0.477,98,289,0.339,395,744,0.531,0.525,131,167,0.784,140,533,673,222,54,47,88,135,1215
Aaron Gordon,19863636,AP,24,ORL,62,62,2017,335,767,0.437,73,237,0.308,262,530,0.494,0.484,151,224,0.674,107,368,475,228,51,39,100,125,894
Evan Fournier,17000000,AL,27,ORL,66,66,2076,434,929,0.467,173,434,0.399,261,495,0.527,0.56,180,220,0.818,18,153,171,209,71,15,125,161,1221
Terrence Ross,12500000,ES,28,ORL,69,0,1889,341,846,0.403,177,504,0.351,164,342,0.48,0.508,157,184,0.853,13,209,222,82,77,24,70,109,1016
Markelle Fultz,9745200,BA,21,ORL,72,60,1996,359,772,0.465,36,135,0.267,323,637,0.507,0.488,116,159,0.73,41,197,238,369,90,11,147,142,870
Al-Farouq Aminu,9258000,AP,29,ORL,18,2,380,25,86,0.291,9,36,0.25,16,50,0.32,0.343,19,29,0.655,24,63,87,21,18,8,17,27,78
D.J. Augustin,7250000,BA,32,ORL,57,13,1420,184,461,0.399,70,201,0.348,114,260,0.438,0.475,161,181,0.89,22,100,122,262,34,1,86,72,599
Jonathan Isaac,5806440,AP,22,ORL,34,32,980,156,332,0.47,32,94,0.34,124,238,0.521,0.518,60,77,0.779,58,173,231,48,53,78,49,83,404
Khem Birch,3000000,P,27,ORL,48,24,922,73,143,0.51,0,1,0.0,73,142,0.514,0.51,66,101,0.653,91,129,220,50,20,23,31,91,212
Michael Carter-Williams,2028594,ES,28,ORL,45,0,833,111,260,0.427,22,75,0.293,89,185,0.481,0.469,79,95,0.832,46,101,147,109,49,22,52,87,323
Wes Iwundu,1618520,AL,25,ORL,52,21,953,97,233,0.416,28,82,0.341,69,151,0.457,0.476,78,97,0.804,24,107,131,60,25,13,26,80,300
Melvin Frazier,1416852,ES,23,ORL,19,0,126,15,34,0.441,8,16,0.5,7,18,0.389,0.559,2,4,0.5,2,8,10,3,9,2,5,11,40
Josh Magette,81678,BA,30,ORL,8,0,38,5,15,0.333,1,4,0.25,4,11,0.364,0.367,1,2,0.5,1,5,6,5,3,1,5,4,12
Bradley Beal,25399705,ES,26,WAS,57,57,2053,593,1303,0.455,170,481,0.353,423,822,0.515,0.52,385,457,0.842,52,190,242,347,71,23,194,126,1741
Ian Mahinmi,15450051,P,33,WAS,38,35,808,104,210,0.495,5,26,0.192,99,184,0.538,0.507,70,113,0.619,78,140,218,49,31,44,45,114,283
C.J. Miles,8730158,AL,32,WAS,10,0,161,19,59,0.322,11,35,0.314,8,24,0.333,0.415,15,20,0.75,4,8,12,12,10,4,4,14,64
Thomas Bryant,8000000,P,22,WAS,46,36,1147,243,418,0.581,37,91,0.407,206,327,0.63,0.626,86,116,0.741,98,233,331,83,25,49,53,103,609
Dāvis Bertāns,7000000,AP,27,WAS,54,4,1583,265,610,0.434,200,472,0.424,65,138,0.471,0.598,104,122,0.852,35,210,245,92,37,33,59,139,834
Ish Smith,6000000,BA,31,WAS,68,23,1787,308,689,0.447,62,169,0.367,246,520,0.473,0.492,62,86,0.721,30,189,219,334,59,30,95,106,740
Rui Hachimura,4469160,AP,21,WAS,48,48,1444,254,545,0.466,25,87,0.287,229,458,0.5,0.489,116,140,0.829,78,216,294,87,37,8,53,105,649
Jerome Robinson,3567720,ES,22,TOT,63,6,979,115,310,0.371,49,153,0.32,66,157,0.42,0.45,40,57,0.702,13,116,129,87,28,17,49,112,319
Moritz Wagner,2063520,P,22,WAS,45,5,835,145,266,0.545,25,80,0.313,120,186,0.645,0.592,78,95,0.821,56,163,219,56,28,19,66,152,393
Shabazz Napier,1845301,BA,28,TOT,56,32,1344,188,456,0.412,76,240,0.317,112,216,0.519,0.496,126,153,0.824,26,132,158,262,69,11,128,101,578
Isaac Bonga,1416852,AL,20,WAS,66,49,1250,118,234,0.504,25,71,0.352,93,163,0.571,0.558,69,85,0.812,71,151,222,76,45,22,58,156,330
Admiral Schofield,1000000,AP,22,WAS,33,2,368,35,92,0.38,19,61,0.311,16,31,0.516,0.484,10,15,0.667,7,40,47,15,8,4,7,50,99
Anžejs Pasečņiks,482144,P,24,WAS,27,0,437,61,116,0.526,0,3,0.0,61,113,0.54,0.526,34,58,0.586,42,65,107,18,9,12,24,75,156
Jerian Grant,196288,ES,27,WAS,6,0,80,10,27,0.37,2,8,0.25,8,19,0.421,0.407,5,7,0.714,2,4,6,9,1,1,3,11,27
Johnathan Williams,106181,AP,24,WAS,15,6,180,19,34,0.559,0,2,0.0,19,32,0.594,0.559,7,13,0.538,24,40,64,8,1,8,5,16,45
Victor Oladipo,21000000,ES,27,IND,19,16,528,97,246,0.394,33,104,0.317,64,142,0.451,0.461,48,59,0.814,9,66,75,56,17,4,47,36,275
Malcolm Brogdon,20000000,BA,27,IND,54,54,1666,326,744,0.438,75,230,0.326,251,514,0.488,0.489,166,186,0.892,46,216,262,381,35,10,131,98,893
Myles Turner,17500000,P,23,IND,62,62,1826,268,587,0.457,86,250,0.344,182,337,0.54,0.53,127,169,0.751,86,321,407,72,46,132,85,166,749
T.J. Warren,10810000,AL,26,IND,67,67,2202,534,997,0.536,91,226,0.403,443,771,0.575,0.581,167,204,0.819,68,212,280,99,78,34,84,187,1326
Jeremy Lamb,10500000,ES,27,IND,46,42,1291,216,479,0.451,53,158,0.335,163,321,0.508,0.506,92,110,0.836,24,176,200,96,55,22,50,104,577
Doug McDermott,7333334,AP,28,IND,69,0,1372,267,547,0.488,128,294,0.435,139,253,0.549,0.605,48,58,0.828,26,148,174,78,12,5,42,117,710
Justin Holiday,4767000,AL,30,IND,73,6,1826,208,486,0.428,134,331,0.405,74,155,0.477,0.566,53,67,0.791,32,206,238,93,87,46,44,137,603
Domantas Sabonis,3529555,AP,23,IND,62,62,2159,458,848,0.54,17,67,0.254,441,781,0.565,0.55,214,296,0.723,189,582,771,310,47,30,170,195,1147
T.J. McConnell,3500000,BA,27,IND,71,3,1326,212,411,0.516,5,17,0.294,207,394,0.525,0.522,35,42,0.833,38,151,189,355,56,11,100,73,464
Goga Bitadze,2816760,P,20,IND,54,2,471,70,150,0.467,8,42,0.19,62,108,0.574,0.493,24,33,0.727,25,81,106,23,10,37,28,65,172
T.J. Leaf,2813280,AP,22,IND,28,1,222,36,86,0.419,5,18,0.278,31,68,0.456,0.448,7,16,0.438,23,48,71,9,10,4,8,22,84
Aaron Holiday,2239200,BA,23,IND,66,33,1617,233,563,0.414,87,221,0.394,146,342,0.427,0.491,74,87,0.851,22,134,156,225,55,16,88,120,627
Edmond Sumner,2000000,ES,24,IND,31,3,447,61,142,0.43,14,53,0.264,47,89,0.528,0.479,16,29,0.552,11,35,46,55,15,9,22,44,152
JaKarr Sampson,1737145,AP,26,IND,34,12,471,68,115,0.591,2,13,0.154,66,102,0.647,0.6,18,27,0.667,20,68,88,21,16,12,15,64,156
Alize Johnson,1416852,AP,23,IND,17,1,118,12,29,0.414,3,8,0.375,9,21,0.429,0.466,7,10,0.7,16,32,48,7,3,2,7,12,34
Zach LaVine,19500000,AL,24,CHI,60,60,2085,539,1199,0.45,184,484,0.38,355,715,0.497,0.526,268,334,0.802,41,248,289,254,88,28,206,131,1530
Thaddeus Young,12900000,AP,31,CHI,64,16,1591,269,601,0.448,79,222,0.356,190,379,0.501,0.513,42,72,0.583,94,221,315,117,92,23,102,134,659
Tomáš Satoranský,9375000,ES,28,CHI,65,64,1878,237,551,0.43,64,199,0.322,173,352,0.491,0.488,106,121,0.876,76,178,254,354,80,7,130,135,644
Cristiano Felício,8156500,P,27,CHI,22,0,386,34,54,0.63,0,2,0.0,34,52,0.654,0.63,18,23,0.783,55,47,102,16,10,2,18,34,86
Kris Dunn,5348007,BA,25,CHI,51,32,1269,152,342,0.444,29,112,0.259,123,230,0.535,0.487,40,54,0.741,23,163,186,173,101,17,68,158,373
Coby White,5307120,BA,19,CHI,65,1,1674,312,792,0.394,133,376,0.354,179,416,0.43,0.478,102,129,0.791,28,202,230,175,49,6,109,117,859
Lauri Markkanen,5300400,AP,22,CHI,50,50,1492,251,591,0.425,109,317,0.344,142,274,0.518,0.517,126,153,0.824,60,253,313,74,42,23,81,96,737
Denzel Valentine,3377569,AL,26,CHI,36,5,488,97,237,0.409,46,137,0.336,51,100,0.51,0.506,6,8,0.75,9,65,74,43,26,6,26,51,246
Ryan Arcidiacono,3000000,BA,25,CHI,58,4,930,90,220,0.409,54,138,0.391,36,82,0.439,0.532,27,38,0.711,20,90,110,96,27,3,37,96,261
Chandler Hutchison,2332320,AL,23,CHI,28,10,527,80,175,0.457,12,38,0.316,68,137,0.496,0.491,46,78,0.59,18,90,108,26,27,7,27,47,218
Luke Kornet,2250000,P,24,CHI,36,14,559,82,187,0.439,31,108,0.287,51,79,0.646,0.521,20,28,0.714,22,62,84,32,11,26,14,54,215
Shaquille Harrison,898310,ES,26,CHI,43,10,484,77,165,0.467,16,42,0.381,61,123,0.496,0.515,39,50,0.78,22,64,86,49,34,19,19,55,209
Kyle Lowry,33296296,BA,33,TOR,58,58,2098,334,803,0.416,164,466,0.352,170,337,0.504,0.518,294,343,0.857,32,260,292,433,82,26,178,190,1126
Marc Gasol,25595700,P,35,TOR,44,43,1161,119,279,0.427,57,148,0.385,62,131,0.473,0.529,36,49,0.735,31,244,275,147,34,38,59,124,331
Serge Ibaka,23271604,P,30,TOR,55,27,1485,343,670,0.512,70,182,0.385,273,488,0.559,0.564,89,124,0.718,114,338,452,77,28,46,109,153,845
Norman Powell,10116576,ES,26,TOR,52,26,1479,296,598,0.495,109,273,0.399,187,325,0.575,0.586,129,153,0.843,26,164,190,91,60,21,77,108,830
Fred VanVleet,9346153,ES,25,TOR,54,54,1928,319,773,0.413,146,374,0.39,173,399,0.434,0.507,168,198,0.848,18,185,203,357,100,17,121,132,952
Patrick McCaw,4000000,AL,24,TOR,37,12,908,67,162,0.414,23,71,0.324,44,91,0.484,0.485,13,18,0.722,19,67,86,79,39,4,29,60,170
Stanley Johnson,3623000,AP,23,TOR,25,0,150,22,59,0.373,7,24,0.292,15,35,0.429,0.432,9,16,0.563,7,30,37,20,6,4,15,16,60
Rondae Hollis-Jefferson,2500000,AP,25,TOR,60,6,1122,155,329,0.471,3,23,0.13,152,306,0.497,0.476,105,143,0.734,110,173,283,106,46,23,59,115,418
Pascal Siakam,2351839,AP,25,TOR,60,60,2110,500,1104,0.453,131,365,0.359,369,739,0.499,0.512,240,303,0.792,64,375,439,207,61,53,148,170,1371
OG Anunoby,2281800,AL,22,TOR,69,68,2066,286,566,0.505,89,228,0.39,197,338,0.583,0.584,72,102,0.706,80,284,364,108,96,45,79,167,733
Malcolm Miller,1588231,AL,26,TOR,28,1,162,12,29,0.414,8,22,0.364,4,7,0.571,0.552,3,8,0.375,2,14,16,11,5,2,4,18,35
Chris Boucher,1488967,P,27,TOR,62,0,819,141,299,0.472,38,118,0.322,103,181,0.569,0.535,91,116,0.784,107,170,277,26,22,61,28,114,411
Dewan Hernandez,898310,P,23,TOR,6,0,28,5,14,0.357,1,2,0.5,4,12,0.333,0.393,3,5,0.6,5,9,14,3,1,0,3,6,14
Terence Davis,898310,ES,22,TOR,72,4,1209,199,436,0.456,94,242,0.388,105,194,0.541,0.564,51,59,0.864,50,187,237,115,39,14,76,124,543
Matt Thomas,898310,ES,25,TOR,41,1,440,73,150,0.487,47,99,0.475,26,51,0.51,0.643,9,12,0.75,9,52,61,22,10,1,16,38,202
Jeff Teague,19000000,BA,31,TOT,59,17,1464,213,489,0.436,43,117,0.368,170,372,0.457,0.48,172,197,0.873,27,115,142,308,44,19,116,106,641
Dewayne Dedmon,13333333,P,30,TOT,44,18,774,102,255,0.4,22,107,0.206,80,148,0.541,0.443,30,36,0.833,60,189,249,22,25,41,57,133,256
De'Andre Hunter,7068360,AL,22,ATL,63,62,2018,280,683,0.41,108,304,0.355,172,379,0.454,0.489,110,144,0.764,44,242,286,112,44,18,103,182,778
Trae Young,6273000,BA,21,ATL,60,60,2120,546,1249,0.437,205,568,0.361,341,681,0.501,0.519,481,559,0.86,32,223,255,560,65,8,289,104,1778
Cam Reddish,4245720,AL,20,ATL,58,34,1551,213,554,0.384,83,250,0.332,130,304,0.428,0.459,101,126,0.802,35,181,216,87,62,28,96,132,610
John Collins,2686560,AP,22,ATL,41,41,1363,353,605,0.583,59,147,0.401,294,458,0.642,0.632,120,150,0.8,116,300,416,60,31,66,75,138,885
Kevin Huerter,2636280,ES,21,ATL,56,48,1760,252,610,0.413,127,334,0.38,125,276,0.453,0.517,53,64,0.828,35,193,228,213,51,27,87,139,684
DeAndre' Bembry,2603982,ES,25,ATL,43,4,915,104,228,0.456,15,65,0.231,89,163,0.546,0.489,26,48,0.542,34,118,152,81,55,19,60,84,249
Vince Carter,2564753,AP,43,ATL,60,0,876,107,304,0.352,61,202,0.302,46,102,0.451,0.452,23,29,0.793,18,106,124,48,23,25,33,90,298
Skal Labissière,2338847,P,23,POR,33,1,567,81,147,0.551,3,13,0.231,78,134,0.582,0.561,25,33,0.758,65,104,169,42,7,31,30,89,190
Damian Jones,2305057,P,24,ATL,55,27,887,121,178,0.68,2,9,0.222,119,169,0.704,0.685,62,84,0.738,74,132,206,35,26,40,28,149,306
Treveon Graham,1645357,AL,26,TOT,55,20,929,87,242,0.36,33,120,0.275,54,122,0.443,0.428,36,56,0.643,51,99,150,45,24,6,29,102,243
Bruno Fernando,1400000,P,21,ATL,56,13,713,103,199,0.518,5,37,0.135,98,162,0.605,0.53,29,51,0.569,67,131,198,49,18,17,42,107,240
Brandon Goodwin,522738,BA,24,ATL,34,1,430,76,190,0.4,26,87,0.299,50,103,0.485,0.468,28,30,0.933,11,61,72,51,12,4,29,43,206
Tyrone Wallace,502491,ES,25,ATL,14,0,160,14,44,0.318,1,15,0.067,13,29,0.448,0.33,11,17,0.647,3,19,22,13,7,1,10,19,40
Paul Watson,50752,AL,25,TOT,10,0,87,10,26,0.385,4,12,0.333,6,14,0.429,0.462,7,9,0.778,2,15,17,8,4,1,3,5,31
Jimmy Butler,32742000,AL,30,MIA,58,58,1959,345,758,0.455,29,119,0.244,316,639,0.495,0.474,438,525,0.834,106,280,386,350,103,32,127,81,1157
Goran Dragić,19217900,BA,33,MIA,59,3,1663,319,724,0.441,124,338,0.367,195,386,0.505,0.526,191,246,0.776,29,158,187,301,40,10,144,124,953
Andre Iguodala,17185185,AL,36,MIA,21,0,418,38,88,0.432,14,47,0.298,24,41,0.585,0.511,6,15,0.4,17,61,78,51,14,21,26,35,96
Solomon Hill,12758781,AP,28,TOT,59,4,1088,110,278,0.396,63,171,0.368,47,107,0.439,0.509,40,54,0.741,29,136,165,104,43,12,51,85,323
Kelly Olynyk,11667885,P,28,MIA,67,9,1300,184,398,0.462,95,234,0.406,89,164,0.543,0.582,86,100,0.86,44,261,305,116,45,23,71,173,549
Meyers Leonard,11286515,P,27,MIA,51,49,1034,119,234,0.509,53,128,0.414,66,106,0.623,0.622,18,28,0.643,30,230,260,55,14,15,39,107,309
Jae Crowder,7815533,AP,29,TOT,65,53,1875,226,563,0.401,135,394,0.343,91,169,0.538,0.521,97,125,0.776,52,332,384,161,72,24,69,143,684
Tyler Herro,3640200,ES,20,MIA,55,8,1508,270,631,0.428,116,298,0.389,154,333,0.462,0.52,87,100,0.87,16,208,224,121,34,9,87,76,743
Bam Adebayo,3454080,AP,22,MIA,72,72,2417,440,790,0.557,2,14,0.143,438,776,0.564,0.558,264,382,0.691,176,559,735,368,82,93,204,182,1146
Udonis Haslem,2564753,P,39,MIA,4,1,44,4,11,0.364,1,3,0.333,3,8,0.375,0.409,3,4,0.75,1,15,16,1,0,0,1,6,12
Kendrick Nunn,1416852,BA,24,MIA,67,67,1962,401,914,0.439,137,391,0.35,264,523,0.505,0.514,85,100,0.85,21,159,180,220,56,15,114,152,1024
Duncan Robinson,1416852,ES,25,MIA,73,68,2166,323,687,0.47,270,606,0.446,53,81,0.654,0.667,67,72,0.931,10,222,232,102,35,19,70,193,983
KZ Okpala,898310,AP,20,MIA,5,0,26,3,5,0.6,0,1,0.0,3,4,0.75,0.6,1,2,0.5,1,4,5,1,2,1,1,2,7
Chris Silva,466918,AP,23,MIA,44,0,346,48,78,0.615,0,3,0.0,48,75,0.64,0.615,37,55,0.673,60,66,126,23,9,21,32,85,133
Kyrie Irving,31742000,BA,27,BRK,20,20,658,199,416,0.478,56,142,0.394,143,274,0.522,0.546,94,102,0.922,22,81,103,128,27,10,52,53,548
Spencer Dinwiddie,10605600,BA,26,BRK,64,49,1994,424,1021,0.415,123,400,0.308,301,621,0.485,0.476,347,446,0.778,32,189,221,432,40,21,174,180,1318
Joe Harris,7666667,AL,28,BRK,69,69,2123,381,784,0.486,172,406,0.424,209,378,0.553,0.596,64,89,0.719,64,234,298,144,41,17,104,159,998
Garrett Temple,4767000,ES,33,BRK,62,35,1730,222,587,0.378,127,386,0.329,95,201,0.473,0.486,70,87,0.805,29,189,218,156,49,29,62,108,641
Taurean Prince,3481986,AP,25,BRK,64,61,1857,278,739,0.376,146,431,0.339,132,308,0.429,0.475,71,89,0.798,50,331,381,116,57,25,127,159,773
Caris LeVert,2625718,ES,25,BRK,45,31,1330,311,732,0.425,80,220,0.364,231,512,0.451,0.48,140,197,0.711,49,140,189,199,53,10,118,81,842
Wilson Chandler,2564753,AP,32,BRK,35,3,734,74,183,0.404,37,121,0.306,37,62,0.597,0.505,20,23,0.87,11,134,145,39,16,12,34,79,205
Jarrett Allen,2376840,P,21,BRK,70,64,1852,302,465,0.649,0,6,0.0,302,459,0.658,0.649,171,270,0.633,216,455,671,110,40,92,77,162,775
Džanan Musa,1911600,AL,20,BRK,40,0,487,64,172,0.372,19,78,0.244,45,94,0.479,0.427,45,60,0.75,21,65,86,43,15,1,36,30,192
Rodions Kurucs,1699236,AP,21,BRK,47,9,684,79,177,0.446,33,90,0.367,46,87,0.529,0.54,24,38,0.632,25,112,137,51,25,5,46,90,215
Nic Claxton,898310,P,20,BRK,15,0,187,27,48,0.563,1,7,0.143,26,41,0.634,0.573,11,21,0.524,19,25,44,16,1,8,9,14,66
Timothé Luwawu-Cabarrot,844170,AL,24,BRK,47,2,853,117,269,0.435,62,160,0.388,55,109,0.505,0.55,69,81,0.852,29,98,127,29,18,7,37,106,365
Iman Shumpert,419443,AL,29,BRK,13,0,241,21,64,0.328,8,33,0.242,13,31,0.419,0.391,4,7,0.571,9,25,34,12,12,2,10,21,54
Justin Anderson,294432,ES,26,BRK,10,1,107,10,38,0.263,6,29,0.207,4,9,0.444,0.342,2,4,0.5,1,20,21,8,0,6,4,13,28
Lance Thomas,262152,AP,31,BRK,7,4,98,8,23,0.348,4,13,0.308,4,10,0.4,0.435,4,4,1.0,2,11,13,6,0,0,6,11,24
Kevin Love,28942830,AP,31,CLE,56,56,1780,327,727,0.45,146,390,0.374,181,337,0.537,0.55,187,219,0.854,54,493,547,178,33,19,140,90,987
Andre Drummond,27093019,P,26,TOT,57,56,1879,418,784,0.533,5,35,0.143,413,749,0.551,0.536,169,294,0.575,250,614,864,152,109,93,203,201,1010
Tristan Thompson,18539130,P,28,CLE,57,51,1721,288,562,0.512,9,23,0.391,279,539,0.518,0.52,99,161,0.615,226,351,577,120,33,50,103,124,684
Matthew Dellavedova,9607500,BA,29,CLE,57,4,821,62,175,0.354,21,91,0.231,41,84,0.488,0.414,32,37,0.865,18,57,75,180,20,2,59,78,177
Dante Exum,9600000,ES,24,TOT,35,1,485,56,119,0.471,15,43,0.349,41,76,0.539,0.534,32,43,0.744,12,55,67,40,13,8,31,38,159
Darius Garland,6400920,ES,20,CLE,59,59,1824,280,699,0.401,105,296,0.355,175,403,0.434,0.476,63,72,0.875,27,84,111,229,42,4,151,92,728
Collin Sexton,4764960,BA,21,CLE,65,65,2143,513,1086,0.472,97,255,0.38,416,831,0.501,0.517,226,267,0.846,61,143,204,192,65,7,158,142,1349
Cedi Osman,2907143,AL,24,CLE,65,65,1910,266,609,0.437,123,321,0.383,143,288,0.497,0.538,63,94,0.67,39,192,231,154,54,16,91,160,718
Alfonzo McKinnie,2391985,AL,27,CLE,40,1,593,73,171,0.427,14,65,0.215,59,106,0.557,0.468,22,31,0.71,37,76,113,14,23,8,26,72,182
Dean Wade,375000,AP,23,CLE,12,0,71,9,13,0.692,2,4,0.5,7,9,0.778,0.769,0,1,0.0,3,16,19,2,2,4,3,8,20
Malik Newman,65978,ES,22,CLE,1,0,4,0,2,0.0,0,1,0.0,0,1,0.0,0.0,2,2,1.0,0,0,0,0,0,0,1,0,2
Khris Middleton,30603448,AL,28,MIL,62,59,1853,471,947,0.497,147,354,0.415,324,593,0.546,0.575,208,227,0.916,44,338,382,265,53,7,137,142,1297
Giannis Antetokounmpo,25842697,AP,25,MIL,63,63,1917,685,1238,0.553,89,293,0.304,596,945,0.631,0.589,398,629,0.633,140,716,856,354,61,66,230,195,1857
Eric Bledsoe,15625000,BA,30,MIL,61,61,1646,334,703,0.475,74,215,0.344,260,488,0.533,0.528,169,214,0.79,43,239,282,328,57,26,148,128,911
Brook Lopez,12093024,P,31,MIL,68,67,1817,292,671,0.435,102,325,0.314,190,346,0.549,0.511,127,152,0.836,58,254,312,99,46,163,70,163,813
George Hill,10133907,BA,33,MIL,59,2,1271,194,376,0.516,81,176,0.46,113,200,0.565,0.624,85,101,0.842,50,127,177,180,47,5,57,84,554
Ersan İlyasova,7000000,AP,32,MIL,63,8,986,146,313,0.466,50,137,0.365,96,176,0.545,0.546,72,87,0.828,62,240,302,49,24,17,34,95,414
Robin Lopez,4767000,P,31,MIL,66,5,958,147,299,0.492,35,105,0.333,112,194,0.577,0.55,28,53,0.528,56,105,161,45,10,45,63,96,357
D.J. Wilson,2961120,AP,23,MIL,37,1,363,52,132,0.394,18,73,0.247,34,59,0.576,0.462,11,18,0.611,12,80,92,25,3,5,19,33,133
Donte DiVincenzo,2905800,ES,23,MIL,66,24,1520,232,510,0.455,83,247,0.336,149,263,0.567,0.536,63,86,0.733,66,252,318,154,85,20,90,113,610
Wesley Matthews,2564753,ES,33,MIL,67,67,1635,167,422,0.396,108,297,0.364,59,125,0.472,0.524,52,68,0.765,22,144,166,92,38,9,43,103,494
Pat Connaughton,1723050,ES,27,MIL,67,4,1243,137,301,0.455,55,166,0.331,82,135,0.607,0.547,31,40,0.775,60,224,284,107,25,31,52,70,360
Sterling Brown,1618520,AL,24,MIL,52,1,767,95,256,0.371,44,136,0.324,51,120,0.425,0.457,32,40,0.8,31,152,183,51,29,7,42,54,266
Thanasis Antetokounmpo,1445697,AL,27,MIL,20,2,129,24,48,0.5,0,10,0.0,24,38,0.632,0.5,7,17,0.412,12,12,24,15,7,2,12,18,55
Julius Randle,18000000,AP,25,NYK,64,64,2080,463,1006,0.46,64,231,0.277,399,775,0.515,0.492,258,352,0.733,151,471,622,198,51,22,193,178,1248
Bobby Portis,15000000,AP,24,NYK,66,5,1393,265,589,0.45,67,187,0.358,198,402,0.493,0.507,71,93,0.763,80,258,338,98,32,18,73,110,668
Maurice Harkless,11511234,AP,26,TOT,62,48,1427,142,283,0.502,34,98,0.347,108,185,0.584,0.562,39,66,0.591,55,185,240,68,58,33,53,148,357
Taj Gibson,9800000,P,34,NYK,62,56,1025,167,286,0.584,4,14,0.286,163,272,0.599,0.591,41,56,0.732,111,156,267,52,27,30,47,122,379
Wayne Ellington,8000000,ES,32,NYK,36,1,558,61,174,0.351,50,143,0.35,11,31,0.355,0.494,11,13,0.846,4,61,65,44,13,4,18,41,183
Elfrid Payton,8000000,BA,25,NYK,45,36,1246,193,440,0.439,14,69,0.203,179,371,0.482,0.455,49,86,0.57,52,160,212,323,70,17,96,89,449
RJ Barrett,7839960,ES,19,NYK,56,55,1704,292,727,0.402,63,197,0.32,229,530,0.432,0.445,156,254,0.614,50,229,279,143,55,17,124,122,803
Frank Ntilikina,4855800,BA,21,NYK,57,26,1187,131,333,0.393,44,137,0.321,87,196,0.444,0.459,51,59,0.864,23,98,121,172,54,16,71,142,357
Kevin Knox,4380120,AL,20,NYK,65,4,1166,144,401,0.359,65,199,0.327,79,202,0.391,0.44,66,101,0.653,28,156,184,61,23,28,45,106,419
Reggie Bullock,4000000,ES,28,NYK,29,19,684,90,224,0.402,37,111,0.333,53,113,0.469,0.484,17,21,0.81,13,55,68,42,25,3,19,56,234
Allonzo Trier,3551100,ES,24,NYK,24,1,291,51,106,0.481,19,53,0.358,32,53,0.604,0.571,34,43,0.791,6,23,29,28,3,4,22,29,155
Damyean Dotson,1618520,ES,25,NYK,48,0,836,120,290,0.414,59,163,0.362,61,127,0.48,0.516,22,33,0.667,10,81,91,57,23,4,21,44,321
Theo Pinson,1445697,ES,24,BRK,33,0,365,45,155,0.29,15,80,0.188,30,75,0.4,0.339,15,16,0.938,10,44,54,56,17,4,33,35,120
Ignas Brazdeikis,898310,AL,21,NYK,9,0,53,6,22,0.273,1,9,0.111,5,13,0.385,0.295,4,5,0.8,2,3,5,4,0,1,2,3,17
Tobias Harris,32742000,AP,27,PHI,72,72,2469,553,1173,0.471,131,357,0.367,422,816,0.517,0.527,174,216,0.806,69,426,495,227,53,40,104,165,1411
Al Horford,28000000,P,33,PHI,67,61,2025,319,709,0.45,99,283,0.35,220,426,0.516,0.52,61,80,0.763,103,353,456,270,52,61,80,142,798
Joel Embiid,27504630,P,25,PHI,51,51,1506,382,801,0.477,57,172,0.331,325,629,0.517,0.512,351,435,0.807,141,452,593,152,45,65,159,174,1172
Josh Richardson,10116576,ES,26,PHI,55,53,1693,278,646,0.43,85,249,0.341,193,397,0.486,0.496,114,141,0.809,41,133,174,162,52,36,104,136,755
Ben Simmons,8113930,BA,23,PHI,57,57,2017,375,647,0.58,2,7,0.286,373,640,0.583,0.581,185,298,0.621,113,331,444,455,119,33,200,186,937
Mike Scott,4767000,AP,31,PHI,68,11,1207,149,350,0.426,80,217,0.369,69,133,0.519,0.54,30,37,0.811,65,183,248,56,21,5,26,96,408
Zhaire Smith,3058800,AL,20,PHI,7,0,32,3,11,0.273,0,3,0.0,3,8,0.375,0.273,2,4,0.5,0,2,2,2,3,0,2,4,8
Matisse Thybulle,2582160,ES,22,PHI,65,14,1287,112,265,0.423,56,157,0.357,56,108,0.519,0.528,25,41,0.61,44,63,107,79,94,47,51,141,305
Alec Burks,2320044,ES,28,TOT,66,19,1754,321,768,0.418,116,301,0.385,205,467,0.439,0.493,235,265,0.887,48,234,282,189,62,17,91,128,993
Kyle O'Quinn,2028594,P,29,PHI,29,2,313,42,85,0.494,7,27,0.259,35,58,0.603,0.535,11,20,0.55,34,82,116,51,7,24,20,37,102
Raul Neto,1737145,BA,27,PHI,54,3,668,101,222,0.455,34,88,0.386,67,134,0.5,0.532,39,47,0.83,11,50,61,95,24,6,47,50,275
Furkan Korkmaz,1620564,ES,22,PHI,72,12,1559,242,563,0.43,143,356,0.402,99,207,0.478,0.557,77,102,0.755,18,150,168,79,41,16,59,98,704
Shake Milton,1445697,ES,23,PHI,40,24,805,134,277,0.484,58,135,0.43,76,142,0.535,0.588,51,65,0.785,15,73,88,104,20,7,47,92,377
Norvel Pelle,350189,P,26,PHI,24,0,232,25,48,0.521,0,1,0.0,25,47,0.532,0.521,7,14,0.5,20,52,72,8,3,31,18,55,57
Kemba Walker,32742000,BA,29,BOS,56,56,1742,378,889,0.425,180,473,0.381,198,416,0.476,0.526,209,242,0.864,36,181,217,268,48,28,117,91,1145
Gordon Hayward,32700690,AL,29,BOS,52,52,1740,350,700,0.5,85,222,0.383,265,478,0.554,0.561,124,145,0.855,55,293,348,212,38,22,96,96,909
Marcus Smart,11768879,ES,25,BOS,60,40,1919,256,682,0.375,137,395,0.347,119,287,0.415,0.476,127,152,0.836,42,183,225,291,101,29,103,162,776
Jayson Tatum,7830000,AP,21,BOS,66,66,2265,552,1226,0.45,189,469,0.403,363,757,0.48,0.527,254,313,0.812,64,396,460,200,93,57,155,136,1547
Jaylen Brown,6534829,ES,23,BOS,57,57,1934,427,887,0.481,129,338,0.382,298,549,0.543,0.554,176,243,0.724,62,302,364,118,65,20,125,167,1159
Daniel Theis,5000000,P,27,BOS,65,64,1566,241,426,0.566,32,96,0.333,209,330,0.633,0.603,87,114,0.763,140,286,426,111,37,84,54,219,601
Enes Freedom,4767000,P,27,BOS,58,7,983,199,348,0.572,1,7,0.143,198,341,0.581,0.573,70,99,0.707,163,268,431,56,22,41,56,100,469
Romeo Langford,3458400,ES,20,BOS,32,2,370,28,80,0.35,5,27,0.185,23,53,0.434,0.381,18,25,0.72,15,26,41,13,8,8,11,33,79
Vincent Poirier,2505793,P,26,BOS,22,0,130,17,36,0.472,1,2,0.5,16,34,0.471,0.486,6,7,0.857,13,30,43,8,2,9,8,25,41
Grant Williams,2379840,AP,21,BOS,69,5,1043,87,211,0.412,24,96,0.25,63,115,0.548,0.469,39,54,0.722,59,119,178,68,30,36,50,163,237
Semi Ojeleye,1618520,AP,25,BOS,69,6,1011,80,196,0.408,48,127,0.378,32,69,0.464,0.531,28,32,0.875,26,119,145,37,21,5,19,80,236
Brad Wanamaker,1355341,BA,30,BOS,71,1,1369,162,362,0.448,37,102,0.363,125,260,0.481,0.499,126,136,0.926,22,122,144,179,61,14,76,133,487
Carsen Edwards,1228026,ES,21,BOS,37,0,351,42,128,0.328,24,76,0.316,18,52,0.346,0.422,13,19,0.684,6,41,47,24,12,4,15,34,121
Javonte Green,898310,ES,26,BOS,48,2,468,63,126,0.5,9,33,0.273,54,93,0.581,0.536,28,42,0.667,24,69,93,26,24,8,23,43,163
Max Strus,415414,AL,23,CHI,2,0,6,2,3,0.667,0,1,0.0,2,2,1.0,0.667,1,1,1.0,1,0,1,0,0,0,0,1,5
DeMar DeRozan,27739975,AP,31,SAS,61,61,2056,455,920,0.495,19,74,0.257,436,846,0.515,0.505,387,440,0.88,40,219,259,422,56,15,119,128,1316
LaMarcus Aldridge,16750000,P,35,TOT,26,23,674,140,296,0.473,31,80,0.388,109,216,0.505,0.525,41,47,0.872,19,99,118,49,11,29,27,47,352
LaMarcus Aldridge,554988,P,35,TOT,26,23,674,140,296,0.473,31,80,0.388,109,216,0.505,0.525,41,47,0.872,19,99,118,49,11,29,27,47,352
Rudy Gay,14500000,AP,34,SAS,63,1,1358,264,628,0.42,106,278,0.381,158,350,0.451,0.505,82,102,0.804,42,261,303,88,45,40,65,115,716
Dejounte Murray,14286000,BA,24,SAS,67,67,2139,441,974,0.453,63,199,0.317,378,775,0.488,0.485,106,134,0.791,58,415,473,363,101,7,117,135,1051
Patty Mills,13535714,BA,32,SAS,68,1,1685,252,611,0.412,161,429,0.375,91,182,0.5,0.544,71,78,0.91,18,98,116,162,42,3,66,81,736
Trey Lyles,5500000,AP,25,SAS,23,9,358,43,90,0.478,14,40,0.35,29,50,0.58,0.556,15,23,0.652,9,77,86,14,6,1,6,13,115
Devin Vassell,4033440,AL,20,SAS,62,7,1056,123,303,0.406,52,150,0.347,71,153,0.464,0.492,43,51,0.843,24,150,174,56,43,18,22,88,341
Derrick White,3516284,ES,26,SAS,36,32,1064,186,453,0.411,84,243,0.346,102,210,0.486,0.503,97,114,0.851,13,94,107,127,26,36,45,91,553
Luka Šamanić,2824320,AP,21,SAS,33,4,308,47,105,0.448,12,43,0.279,35,62,0.565,0.505,16,29,0.552,16,52,68,15,8,8,20,43,122
Keldon Johnson,2048040,AL,21,SAS,69,67,1968,338,705,0.479,60,181,0.331,278,524,0.531,0.522,145,196,0.74,93,319,412,121,40,24,78,142,881
Marquese Chriss,1824003,AP,23,GSW,2,0,27,5,14,0.357,1,5,0.2,4,9,0.444,0.393,2,4,0.5,3,10,13,2,0,2,2,3,13
Drew Eubanks,1620564,P,23,SAS,54,3,755,116,205,0.566,2,2,1.0,114,203,0.562,0.571,77,106,0.726,74,167,241,42,18,49,45,88,311
DaQuan Jeffries,1445697,ES,23,TOT,31,5,493,50,120,0.417,20,67,0.299,30,53,0.566,0.5,7,8,0.875,19,52,71,22,15,10,14,48,127
Gorgui Dieng,1000000,P,31,TOT,38,1,552,85,163,0.521,30,70,0.429,55,93,0.591,0.613,58,67,0.866,40,100,140,48,26,16,32,56,258
Gorgui Dieng,16587688,P,31,TOT,38,1,552,85,163,0.521,30,70,0.429,55,93,0.591,0.613,58,67,0.866,40,100,140,48,26,16,32,56,258
Tre Jones,898310,BA,21,SAS,37,1,269,37,78,0.474,3,5,0.6,34,73,0.466,0.494,17,19,0.895,8,13,21,39,8,0,13,13,94
John Wall,40866760,BA,30,HOU,40,40,1288,293,726,0.404,79,249,0.317,214,477,0.449,0.458,158,211,0.749,17,112,129,275,42,31,141,46,823
Eric Gordon,16869276,ES,32,HOU,27,13,789,159,367,0.433,69,210,0.329,90,157,0.573,0.527,94,114,0.825,8,50,58,71,14,13,51,44,481
Christian Wood,13015874,P,25,HOU,41,41,1326,329,640,0.514,77,206,0.374,252,434,0.581,0.574,125,198,0.631,76,319,395,71,34,48,80,88,860
Kelly Olynyk,12819649,AP,29,TOT,70,62,1997,337,697,0.484,126,368,0.342,211,329,0.641,0.574,145,175,0.829,87,402,489,203,79,42,126,207,945
Dante Exum,9600000,ES,25,CLE,6,3,116,10,26,0.385,2,11,0.182,8,15,0.533,0.423,1,2,0.5,2,15,17,13,4,2,7,9,23
D.J. Augustin,6666667,BA,33,TOT,57,12,1129,135,343,0.394,83,217,0.382,52,126,0.413,0.515,85,94,0.904,20,74,94,188,28,1,65,56,438
Avery Bradley,5635000,ES,30,TOT,27,6,602,64,171,0.374,33,101,0.327,31,70,0.443,0.471,12,15,0.8,8,49,57,46,21,3,28,55,173
D.J. Wilson,4548280,AP,24,TOT,35,1,433,68,168,0.405,30,87,0.345,38,81,0.469,0.494,17,25,0.68,20,92,112,23,11,16,22,44,183
Ben McLemore,2283034,ES,27,TOT,53,5,905,135,365,0.37,97,280,0.346,38,85,0.447,0.503,39,53,0.736,15,85,100,39,23,9,42,88,406
Ben McLemore,455090,ES,27,TOT,53,5,905,135,365,0.37,97,280,0.346,38,85,0.447,0.503,39,53,0.736,15,85,100,39,23,9,42,88,406
David Nwaba,1824003,AL,28,HOU,30,9,679,106,218,0.486,17,63,0.27,89,155,0.574,0.525,47,68,0.691,40,78,118,31,30,21,17,60,276
Sterling Brown,1620564,ES,25,HOU,51,14,1229,150,335,0.448,91,215,0.423,59,120,0.492,0.584,25,31,0.806,38,186,224,72,38,12,41,97,416
DeMarcus Cousins,1620564,P,30,TOT,41,11,713,130,305,0.426,47,135,0.348,83,170,0.488,0.503,59,81,0.728,53,210,263,76,34,24,64,107,366
DeMarcus Cousins,455091,P,30,TOT,41,11,713,130,305,0.426,47,135,0.348,83,170,0.488,0.503,59,81,0.728,53,210,263,76,34,24,64,107,366
Jae'Sean Tate,1445967,AL,25,HOU,70,58,2043,316,625,0.506,60,195,0.308,256,430,0.595,0.554,102,147,0.694,132,242,374,178,85,36,98,222,794
Bruno Caboclo,361256,AP,25,HOU,6,0,36,8,17,0.471,0,5,0.0,8,12,0.667,0.471,1,2,0.5,3,11,14,1,0,2,4,6,17
Khyri Thomas,360998,ES,24,HOU,5,2,153,32,66,0.485,9,27,0.333,23,39,0.59,0.553,9,9,1.0,7,11,18,25,9,6,6,8,82
Khyri Thomas,744684,ES,24,HOU,5,2,153,32,66,0.485,9,27,0.333,23,39,0.59,0.553,9,9,1.0,7,11,18,25,9,6,6,8,82
Mason Jones,61528,ES,22,TOT,32,1,334,52,123,0.423,24,66,0.364,28,57,0.491,0.52,40,64,0.625,7,48,55,42,7,1,29,24,168
Cameron Oliver,43070,AL,24,HOU,4,0,87,19,33,0.576,4,13,0.308,15,20,0.75,0.636,1,4,0.25,5,16,21,5,2,4,3,11,43
Damian Lillard,31626953,BA,30,POR,67,67,2398,602,1334,0.451,275,704,0.391,327,630,0.519,0.554,449,484,0.928,32,251,283,505,62,17,203,102,1928
CJ McCollum,29354152,ES,29,POR,47,47,1600,405,884,0.458,169,420,0.402,236,464,0.509,0.554,108,133,0.812,30,155,185,223,44,21,65,87,1087
Jusuf Nurkić,12888889,P,26,POR,37,37,880,171,333,0.514,12,30,0.4,159,303,0.525,0.532,70,113,0.619,86,246,332,125,38,39,73,103,424
Robert Covington,12138345,AP,30,POR,70,70,2243,204,509,0.401,135,356,0.379,69,153,0.451,0.533,50,62,0.806,61,405,466,117,101,84,64,195,593
Norman Powell,10865952,AL,27,TOT,69,58,2205,438,918,0.477,171,416,0.411,267,502,0.532,0.57,236,271,0.871,42,173,215,129,82,18,119,160,1283
Enes Freedom,5005350,P,28,POR,72,35,1758,339,561,0.604,1,4,0.25,338,557,0.607,0.605,127,164,0.774,284,511,795,84,33,48,78,168,806
Anfernee Simons,2252040,ES,21,POR,64,0,1104,168,401,0.419,120,282,0.426,48,119,0.403,0.569,46,57,0.807,14,126,140,89,18,8,43,96,502
Nassir Little,2210640,AP,20,POR,48,2,640,78,167,0.467,28,80,0.35,50,87,0.575,0.551,36,45,0.8,32,96,128,23,5,13,18,51,220
Anderson Varejão,1913345,P,38,CLE,5,0,36,4,16,0.25,0,1,0.0,4,15,0.267,0.25,5,9,0.556,7,13,20,3,0,2,1,3,13
Anderson Varejão,144297,P,38,CLE,5,0,36,4,16,0.25,0,1,0.0,4,15,0.267,0.25,5,9,0.556,7,13,20,3,0,2,1,3,13
Carmelo Anthony,1620564,AP,36,POR,69,3,1690,327,777,0.421,133,325,0.409,194,452,0.429,0.506,137,154,0.89,32,182,214,104,46,38,61,144,924
Harry Giles,1620564,P,22,POR,38,0,348,42,97,0.433,8,23,0.348,34,74,0.459,0.474,16,27,0.593,31,102,133,29,8,13,20,54,108
CJ Elleby,898310,AL,20,POR,30,0,192,25,66,0.379,7,34,0.206,18,32,0.563,0.432,11,15,0.733,11,21,32,10,6,3,5,27,68
Rondae Hollis-Jefferson,432891,AP,26,POR,11,1,107,9,18,0.5,0,1,0.0,9,17,0.529,0.5,9,16,0.563,11,15,26,13,2,4,2,15,27
Mike Conley,34504132,BA,33,UTA,51,51,1498,284,640,0.444,138,335,0.412,146,305,0.479,0.552,121,142,0.852,36,141,177,305,70,9,99,98,827
Rudy Gobert,27525281,P,28,UTA,71,71,2187,391,579,0.675,0,4,0.0,391,575,0.68,0.675,233,374,0.623,240,720,960,89,40,190,118,163,1015
Bojan Bogdanović,17661000,AL,31,UTA,72,72,2216,406,925,0.439,180,461,0.39,226,464,0.487,0.536,233,265,0.879,40,241,281,136,45,4,128,115,1225
Jordan Clarkson,11500000,ES,28,UTA,68,1,1818,457,1075,0.425,208,599,0.347,249,476,0.523,0.522,129,144,0.896,47,227,274,168,61,10,115,110,1251
Joe Ingles,10863637,AL,33,UTA,67,30,1867,275,562,0.489,183,406,0.451,92,156,0.59,0.652,76,90,0.844,27,217,244,318,45,12,117,120,809
Derrick Favors,9258000,P,29,UTA,68,0,1039,155,243,0.638,0,2,0.0,155,241,0.643,0.638,59,80,0.738,138,238,376,44,32,68,36,143,369
Royce O'Neale,8500000,AL,27,UTA,71,71,2241,175,394,0.444,107,278,0.385,68,116,0.586,0.58,39,46,0.848,88,397,485,181,57,32,83,182,496
Donovan Mitchell,5195501,BA,24,UTA,53,53,1771,478,1091,0.438,178,461,0.386,300,630,0.476,0.52,267,316,0.845,50,185,235,277,52,15,147,117,1401
Georges Niang,1783557,AP,27,UTA,72,10,1154,177,405,0.437,124,292,0.425,53,113,0.469,0.59,22,23,0.957,28,148,176,59,25,8,51,116,500
Matt Thomas,1517981,ES,26,TOT,45,0,326,50,127,0.394,27,80,0.338,23,47,0.489,0.5,12,14,0.857,7,37,44,19,4,0,14,18,139
Miye Oni,1517981,ES,23,UTA,54,0,519,35,99,0.354,30,88,0.341,5,11,0.455,0.505,5,6,0.833,23,61,84,28,11,8,16,61,105
Juwan Morgan,1517981,AP,23,UTA,29,0,147,14,30,0.467,4,13,0.308,10,17,0.588,0.533,3,7,0.429,9,19,28,9,4,1,4,21,35
Elijah Hughes,898310,AL,22,UTA,18,0,64,10,30,0.333,8,23,0.348,2,7,0.286,0.467,3,4,0.75,1,8,9,6,1,1,6,1,31
Shaquille Harrison,770433,ES,27,TOT,34,0,333,26,78,0.333,3,16,0.188,23,62,0.371,0.353,18,22,0.818,7,41,48,25,17,5,11,33,73
Ersan İlyasova,754783,AP,33,UTA,17,1,148,21,54,0.389,18,41,0.439,3,13,0.231,0.556,5,5,1.0,7,22,29,4,10,3,8,29,65
Kristaps Porziņģis,29467800,P,25,DAL,43,43,1327,325,683,0.476,97,258,0.376,228,425,0.536,0.547,118,138,0.855,82,299,381,68,20,58,51,115,865
Dwight Powell,11080125,P,29,DAL,58,19,966,120,194,0.619,5,21,0.238,115,173,0.665,0.631,97,124,0.782,80,154,234,63,36,30,40,135,342
Josh Richardson,10865952,ES,27,DAL,59,56,1790,264,618,0.427,88,267,0.33,176,351,0.501,0.498,99,108,0.917,51,144,195,153,61,24,79,130,715
Maxi Kleber,8325000,AP,29,DAL,50,40,1341,116,275,0.422,87,212,0.41,29,63,0.46,0.58,34,37,0.919,47,213,260,68,24,35,30,105,353
Luka Dončić,8049360,BA,21,DAL,66,66,2262,647,1351,0.479,192,548,0.35,455,803,0.567,0.55,344,471,0.73,54,473,527,567,64,36,281,152,1830
Willie Cauley-Stein,4100000,P,27,DAL,53,16,906,115,182,0.632,1,11,0.091,114,171,0.667,0.635,49,78,0.628,66,170,236,35,21,43,29,129,280
Dorian Finney-Smith,4000000,AP,27,DAL,60,60,1921,220,466,0.472,119,302,0.394,101,164,0.616,0.6,31,41,0.756,98,228,326,102,52,25,48,138,590
Nicolò Melli,3897436,AP,30,TOT,45,4,566,46,141,0.326,23,85,0.271,23,56,0.411,0.408,19,25,0.76,29,93,122,44,14,3,12,58,134
Boban Marjanović,3500000,P,32,DAL,33,3,271,62,122,0.508,1,8,0.125,61,114,0.535,0.512,31,38,0.816,47,81,128,10,2,6,12,29,156
Trey Burke,3000000,BA,28,DAL,62,1,911,151,353,0.428,58,164,0.354,93,189,0.492,0.51,51,57,0.895,10,44,54,81,36,7,33,64,411
Josh Green,2816760,ES,20,DAL,39,5,445,42,93,0.452,4,25,0.16,38,68,0.559,0.473,13,23,0.565,28,50,78,28,16,3,17,35,101
Jalen Brunson,1663861,BA,24,DAL,68,12,1697,328,627,0.523,81,200,0.405,247,427,0.578,0.588,120,151,0.795,27,204,231,239,35,1,80,109,857
Tyrell Terry,1289846,BA,20,DAL,11,0,56,5,16,0.313,0,7,0.0,5,9,0.556,0.313,1,3,0.333,0,6,6,6,5,0,2,2,11
Steven Adams,29592695,P,27,NOP,58,58,1605,189,308,0.614,0,3,0.0,189,305,0.62,0.614,60,135,0.444,213,301,514,111,54,38,78,113,438
Brandon Ingram,27285000,AL,23,NOP,61,61,2093,513,1101,0.466,143,375,0.381,370,726,0.51,0.531,281,320,0.878,34,265,299,296,42,36,154,124,1450
Eric Bledsoe,16875000,ES,31,NOP,71,70,2111,307,730,0.421,121,355,0.341,186,375,0.496,0.503,134,195,0.687,29,215,244,268,55,24,114,112,869
James Johnson,16047100,AP,33,TOT,51,12,1043,146,327,0.446,31,120,0.258,115,207,0.556,0.494,45,76,0.592,32,145,177,98,42,42,55,120,368
Lonzo Ball,11003782,BA,23,NOP,55,55,1747,290,700,0.414,172,455,0.378,118,245,0.482,0.537,50,64,0.781,33,230,263,316,82,31,123,103,802
Zion Williamson,10245480,AP,20,NOP,61,61,2026,634,1037,0.611,10,34,0.294,624,1003,0.622,0.616,369,529,0.698,167,274,441,226,57,39,167,135,1647
Jaxson Hayes,5105160,P,20,NOP,60,3,964,175,280,0.625,6,14,0.429,169,266,0.635,0.636,93,120,0.775,92,165,257,35,25,38,39,101,449
Josh Hart,3491159,AL,25,NOP,47,4,1349,151,344,0.439,63,193,0.326,88,151,0.583,0.531,69,89,0.775,53,324,377,109,38,12,49,111,434
Nickeil Alexander-Walker,3113160,ES,22,NOP,46,13,1007,192,458,0.419,76,219,0.347,116,239,0.485,0.502,48,66,0.727,13,131,144,102,47,22,69,88,508
Wes Iwundu,1678854,AL,26,TOT,41,4,539,34,102,0.333,5,41,0.122,29,61,0.475,0.358,26,31,0.839,15,75,90,18,15,4,19,49,99
Willy Hernangómez,1620564,P,26,NOP,47,12,846,151,268,0.563,1,10,0.1,150,258,0.581,0.565,62,93,0.667,117,217,334,50,22,23,34,68,365
Wenyen Gabriel,1620564,AP,23,NOP,21,0,241,24,60,0.4,13,32,0.406,11,28,0.393,0.508,11,17,0.647,20,34,54,11,9,8,15,32,72
Sindarius Thornwell,943480,ES,26,TOT,21,1,217,15,46,0.326,7,23,0.304,8,23,0.348,0.402,4,8,0.5,3,15,18,21,13,2,7,15,41
Naji Marshall,120000,AL,23,NOP,32,10,700,82,209,0.392,29,83,0.349,53,126,0.421,0.462,53,75,0.707,15,133,148,88,26,10,38,58,246
Isaiah Thomas,110998,BA,31,NOP,3,0,48,9,27,0.333,3,12,0.25,6,15,0.4,0.389,2,2,1.0,1,3,4,5,1,0,6,3,23
Al Horford,27500000,P,34,OKC,28,28,782,162,360,0.45,56,152,0.368,106,208,0.51,0.528,18,22,0.818,29,159,188,94,25,26,29,48,398
Darius Miller,7000000,AL,30,OKC,18,0,197,22,48,0.458,17,42,0.405,5,6,0.833,0.635,12,12,1.0,2,22,24,21,13,5,8,13,73
Justin Jackson,5029650,AL,25,TOT,34,3,577,89,221,0.403,36,117,0.308,53,104,0.51,0.484,31,37,0.838,16,61,77,52,15,2,32,32,245
Shai Gilgeous-Alexander,4141320,ES,22,OKC,35,35,1180,287,565,0.508,71,170,0.418,216,395,0.547,0.571,185,229,0.808,19,147,166,207,27,23,106,70,830
Gabriel Deck,3870370,AP,25,OKC,10,0,212,32,67,0.478,2,15,0.133,30,52,0.577,0.493,18,22,0.818,16,24,40,24,8,0,6,9,84
Tony Bradley,3542060,P,23,TOT,42,8,684,131,197,0.665,0,3,0.0,131,194,0.675,0.665,38,55,0.691,85,154,239,37,15,30,33,61,300
Austin Rivers,3500000,ES,28,TOT,36,7,845,104,245,0.424,55,149,0.369,49,96,0.51,0.537,22,31,0.71,8,74,82,81,30,2,36,64,285
Austin Rivers,299694,ES,28,TOT,36,7,845,104,245,0.424,55,149,0.369,49,96,0.51,0.537,22,31,0.71,8,74,82,81,30,2,36,64,285
Aleksej Pokusevski,2964840,AP,19,OKC,45,28,1090,139,408,0.341,58,207,0.28,81,201,0.403,0.412,31,42,0.738,30,182,212,97,20,42,99,58,367
Darius Bazley,2399160,AP,20,OKC,55,55,1714,273,690,0.396,83,286,0.29,190,404,0.47,0.456,125,178,0.702,51,345,396,99,29,25,122,60,754
Ty Jerome,2303040,ES,23,OKC,33,1,788,128,287,0.446,71,168,0.423,57,119,0.479,0.57,26,34,0.765,10,81,91,120,20,6,47,61,353
Mike Muscala,2283034,P,29,OKC,35,0,645,119,267,0.446,68,184,0.37,51,83,0.614,0.573,33,36,0.917,19,113,132,28,8,11,21,54,339
Kenrich Williams,2000000,AP,26,OKC,66,13,1426,219,411,0.533,52,117,0.444,167,294,0.568,0.596,36,63,0.571,84,189,273,152,55,17,76,143,526
Théo Maledon,2000000,BA,19,OKC,65,49,1778,226,614,0.368,105,313,0.335,121,301,0.402,0.454,101,135,0.748,25,186,211,227,56,11,141,126,658
Svi Mykhailiuk,1663861,AL,23,TOT,66,14,1324,208,506,0.411,105,314,0.334,103,192,0.536,0.515,38,50,0.76,24,139,163,110,51,12,88,63,559
Luguentz Dort,1517981,ES,21,OKC,52,52,1543,247,639,0.387,113,329,0.343,134,310,0.432,0.475,122,164,0.744,38,151,189,88,45,19,79,134,729
Isaiah Roby,1517981,AP,22,OKC,61,34,1425,207,429,0.483,32,109,0.294,175,320,0.547,0.52,87,117,0.744,89,252,341,107,52,37,113,162,533
Patrick Patterson,737067,AP,31,LAC,38,5,582,72,165,0.436,40,112,0.357,32,53,0.604,0.558,13,17,0.765,19,56,75,29,14,8,11,45,197
Patrick Patterson,3077704,AP,31,LAC,38,5,582,72,165,0.436,40,112,0.357,32,53,0.604,0.558,13,17,0.765,19,56,75,29,14,8,11,45,197
Frank Jackson,250000,BA,22,DET,40,6,738,134,293,0.457,61,150,0.407,73,143,0.51,0.561,61,75,0.813,15,71,86,36,15,1,34,53,390
Justin Robinson,198040,BA,23,OKC,9,0,88,7,21,0.333,4,14,0.286,3,7,0.429,0.429,3,5,0.6,1,6,7,9,3,0,2,10,21
Karl-Anthony Towns,29467800,P,25,MIN,50,50,1689,425,875,0.486,122,315,0.387,303,560,0.541,0.555,267,311,0.859,133,396,529,225,39,57,160,186,1239
D'Angelo Russell,28649250,BA,24,MIN,42,26,1196,281,652,0.431,120,310,0.387,161,342,0.471,0.523,114,149,0.765,16,95,111,244,45,18,112,68,796
Ricky Rubio,17000000,BA,30,MIN,68,51,1772,193,498,0.388,66,214,0.308,127,284,0.447,0.454,130,150,0.867,28,195,223,433,98,4,111,139,582
Malik Beasley,13425895,ES,24,MIN,37,36,1214,264,600,0.44,128,321,0.399,136,279,0.487,0.547,68,80,0.85,28,134,162,88,30,7,60,62,724
Anthony Edwards,9757440,ES,19,MIN,72,55,2314,505,1211,0.417,171,520,0.329,334,691,0.483,0.488,211,272,0.776,59,277,336,211,82,36,160,129,1392
Jarrett Culver,6104280,ES,21,MIN,34,7,499,69,168,0.411,13,53,0.245,56,115,0.487,0.449,29,48,0.604,34,70,104,24,17,9,28,58,180
Juancho Hernangómez,5718000,AP,25,MIN,52,6,900,130,299,0.435,55,168,0.327,75,131,0.573,0.527,60,97,0.619,45,160,205,35,19,7,27,52,375
Jake Layman,3761085,AL,26,MIN,45,11,627,91,184,0.495,23,78,0.295,68,106,0.642,0.557,26,37,0.703,13,54,67,28,29,19,26,44,231
Josh Okogie,2651040,ES,22,MIN,59,37,1197,102,254,0.402,29,108,0.269,73,146,0.5,0.459,83,108,0.769,63,93,156,63,54,28,43,123,316
Jaden McDaniels,1964760,AP,20,MIN,63,27,1511,164,367,0.447,72,198,0.364,92,169,0.544,0.545,27,45,0.6,52,180,232,71,35,60,47,172,427
Jarred Vanderbilt,1663861,AP,21,MIN,64,30,1139,143,236,0.606,1,5,0.2,142,231,0.615,0.608,57,102,0.559,118,250,368,76,64,46,53,123,344
Jaylen Nowell,1517981,ES,21,MIN,42,0,759,142,335,0.424,50,150,0.333,92,185,0.497,0.499,45,55,0.818,19,76,95,62,22,12,28,72,379
Naz Reid,1517981,P,21,MIN,70,15,1347,304,581,0.523,61,174,0.351,243,407,0.597,0.576,115,166,0.693,82,240,322,72,34,76,69,179,784
LeBron James,39219566,BA,36,LAL,45,45,1504,422,823,0.513,104,285,0.365,318,538,0.591,0.576,178,255,0.698,29,317,346,350,48,25,168,70,1126
Anthony Davis,32742000,AP,27,LAL,36,36,1162,301,613,0.491,26,100,0.26,275,513,0.536,0.512,158,214,0.738,62,224,286,110,45,59,74,60,786
Dennis Schröder,16000000,ES,27,LAL,61,61,1956,332,760,0.437,71,212,0.335,261,548,0.476,0.484,206,243,0.848,30,181,211,351,70,13,163,159,941
Kentavious Caldwell-Pope,12073020,ES,27,LAL,67,67,1902,218,506,0.431,120,293,0.41,98,213,0.46,0.549,97,112,0.866,27,152,179,127,62,26,66,114,653
Montrezl Harrell,9258000,P,27,LAL,69,1,1580,375,603,0.622,0,10,0.0,375,593,0.632,0.622,181,256,0.707,158,270,428,73,46,49,74,128,931
Wesley Matthews,3623000,ES,34,LAL,58,10,1130,89,252,0.353,66,197,0.335,23,55,0.418,0.484,35,41,0.854,20,73,93,54,38,17,26,80,279
Kyle Kuzma,3562178,AL,25,LAL,68,32,1954,335,757,0.443,137,380,0.361,198,377,0.525,0.533,67,97,0.691,108,309,417,127,35,41,113,121,874
Alex Caruso,2750000,BA,26,LAL,58,6,1216,133,305,0.436,55,137,0.401,78,168,0.464,0.526,49,76,0.645,31,139,170,160,64,15,76,108,370
Marc Gasol,2564753,P,36,LAL,52,42,993,88,194,0.454,50,122,0.41,38,72,0.528,0.582,36,50,0.72,38,177,215,109,26,58,53,115,262
Quinn Cook,1797183,BA,27,TOT,23,0,157,29,68,0.426,11,26,0.423,18,42,0.429,0.507,7,8,0.875,2,15,17,18,4,1,7,10,76
Quinn Cook,221996,BA,27,TOT,23,0,157,29,68,0.426,11,26,0.423,18,42,0.429,0.507,7,8,0.875,2,15,17,18,4,1,7,10,76
Alfonzo McKinnie,1762796,AL,28,LAL,39,0,258,48,93,0.516,16,39,0.41,32,54,0.593,0.602,10,18,0.556,22,32,54,6,7,0,5,26,122
Markieff Morris,1620564,AP,31,LAL,61,27,1200,153,378,0.405,65,209,0.311,88,169,0.521,0.491,36,50,0.72,48,218,266,73,22,19,54,105,407
Talen Horton-Tucker,1517981,ES,20,LAL,65,4,1304,224,489,0.458,37,131,0.282,187,358,0.522,0.496,100,129,0.775,25,144,169,181,63,21,105,127,585
Jordan Bell,580062,P,26,TOT,6,1,82,7,22,0.318,0,2,0.0,7,20,0.35,0.318,1,2,0.5,7,17,24,7,3,5,4,7,15
Jordan Bell,221996,P,26,TOT,6,1,82,7,22,0.318,0,2,0.0,7,20,0.35,0.318,1,2,0.5,7,17,24,7,3,5,4,7,15
Andre Drummond,554988,P,27,TOT,46,46,1242,282,572,0.493,0,8,0.0,282,564,0.5,0.493,123,205,0.6,166,385,551,94,63,49,124,149,687
Andre Drummond,27957238,P,27,TOT,46,46,1242,282,572,0.493,0,8,0.0,282,564,0.5,0.493,123,205,0.6,166,385,551,94,63,49,124,149,687
Damian Jones,221996,P,25,TOT,39,10,547,70,103,0.68,1,5,0.2,69,98,0.704,0.684,42,58,0.724,36,85,121,29,11,29,26,77,183
Damian Jones,785285,P,25,TOT,39,10,547,70,103,0.68,1,5,0.2,69,98,0.704,0.684,42,58,0.724,36,85,121,29,11,29,26,77,183
Damian Jones,459961,P,25,TOT,39,10,547,70,103,0.68,1,5,0.2,69,98,0.704,0.684,42,58,0.724,36,85,121,29,11,29,26,77,183
Stephen Curry,43006362,BA,32,GSW,63,63,2152,658,1365,0.482,337,801,0.421,321,564,0.569,0.605,362,395,0.916,29,316,345,363,77,8,213,119,2015
Andrew Wiggins,29542010,AP,25,GSW,71,71,2364,505,1058,0.477,140,368,0.38,365,690,0.529,0.543,170,238,0.714,82,265,347,167,67,70,126,159,1320
Draymond Green,22246956,AP,30,GSW,63,63,1982,170,380,0.447,34,126,0.27,136,254,0.535,0.492,70,88,0.795,55,394,449,558,105,52,188,194,444
James Wiseman,8730240,P,19,GSW,39,27,836,191,368,0.519,12,38,0.316,179,330,0.542,0.535,54,86,0.628,55,171,226,26,11,36,60,121,448
Kevon Looney,4821429,P,24,GSW,61,34,1161,108,197,0.548,4,17,0.235,104,180,0.578,0.558,31,48,0.646,117,205,322,119,21,22,37,136,251
Jordan Poole,2063280,ES,21,GSW,51,7,988,205,474,0.432,97,276,0.351,108,198,0.545,0.535,105,119,0.882,15,77,92,99,26,9,51,86,612
Damion Lee,1762796,ES,28,GSW,57,1,1079,128,274,0.467,77,194,0.397,51,80,0.638,0.608,40,44,0.909,22,158,180,73,38,8,30,89,373
Kent Bazemore,1620564,AL,31,GSW,67,18,1333,176,392,0.449,75,184,0.408,101,208,0.486,0.545,54,78,0.692,26,203,229,108,69,33,82,158,481
Mychal Mulder,1517981,BA,26,GSW,60,6,766,119,265,0.449,85,214,0.397,34,51,0.667,0.609,14,22,0.636,8,52,60,26,12,12,16,56,337
Eric Paschall,1517981,AP,24,GSW,40,2,695,148,298,0.497,18,54,0.333,130,244,0.533,0.527,67,94,0.713,28,100,128,51,12,7,43,68,381
Alen Smailagić,1517981,AP,20,GSW,15,1,84,11,27,0.407,4,10,0.4,7,17,0.412,0.481,2,6,0.333,6,10,16,4,3,5,5,11,28
Juan Toscano-Anderson,358295,ES,27,GSW,53,16,1107,121,209,0.579,37,92,0.402,84,117,0.718,0.667,22,31,0.71,29,205,234,150,41,26,61,111,301
Paul George,35450412,AL,30,LAC,54,54,1821,445,953,0.467,171,416,0.411,274,537,0.51,0.557,198,228,0.868,45,314,359,280,62,24,179,132,1259
Kawhi Leonard,34379100,AL,29,LAC,52,52,1773,465,908,0.512,101,254,0.398,364,654,0.557,0.568,261,295,0.885,55,282,337,269,81,21,105,82,1292
Marcus Morris,14883721,AP,31,LAC,57,29,1502,276,584,0.473,140,296,0.473,136,288,0.472,0.592,73,89,0.82,35,199,234,58,34,15,57,117,765
Patrick Beverley,13333333,BA,32,LAC,37,34,832,93,220,0.423,56,141,0.397,37,79,0.468,0.55,36,45,0.8,29,90,119,76,29,28,34,108,278
Serge Ibaka,9258000,P,31,LAC,41,39,955,186,365,0.51,39,115,0.339,147,250,0.588,0.563,43,53,0.811,73,202,275,74,9,47,44,76,454
Rajon Rondo,8250000,BA,34,TOT,45,3,770,95,215,0.442,36,89,0.404,59,126,0.468,0.526,16,17,0.941,18,92,110,199,37,4,79,53,242
Ivica Zubac,7000000,P,23,LAC,72,33,1609,257,394,0.652,1,4,0.25,256,390,0.656,0.654,135,171,0.789,189,330,519,90,24,62,81,187,650
Luke Kennard,5273826,ES,24,LAC,63,17,1232,197,414,0.476,100,224,0.446,97,190,0.511,0.597,26,31,0.839,15,146,161,104,23,9,48,91,520
Reggie Jackson,1620564,ES,30,LAC,67,43,1544,263,585,0.45,122,282,0.433,141,303,0.465,0.554,67,82,0.817,24,168,192,205,41,7,74,127,715
Nicolas Batum,1620564,AL,32,LAC,67,38,1835,191,412,0.464,110,272,0.404,81,140,0.579,0.597,48,58,0.828,50,266,316,148,69,37,53,102,540
Nicolas Batum,8856969,AL,32,LAC,67,38,1835,191,412,0.464,110,272,0.404,81,140,0.579,0.597,48,58,0.828,50,266,316,148,69,37,53,102,540
Terance Mann,1517984,ES,24,LAC,67,10,1263,178,350,0.509,38,91,0.418,140,259,0.541,0.563,78,94,0.83,56,186,242,104,29,13,40,126,472
Daniel Oturu,898310,P,21,LAC,30,0,161,22,52,0.423,1,5,0.2,21,47,0.447,0.433,9,12,0.75,21,27,48,10,4,7,9,24,54
Yogi Ferrell,325167,BA,27,TOT,10,0,136,20,57,0.351,9,28,0.321,11,29,0.379,0.43,7,9,0.778,5,14,19,22,7,3,3,11,56
Yogi Ferrell,110998,BA,27,TOT,10,0,136,20,57,0.351,9,28,0.321,11,29,0.379,0.43,7,9,0.778,5,14,19,22,7,3,3,11,56
Chris Paul,41358814,BA,35,PHO,70,70,2199,439,879,0.499,102,258,0.395,337,621,0.543,0.557,169,181,0.934,25,287,312,622,99,19,156,166,1149
Devin Booker,29467800,ES,24,PHO,67,67,2270,623,1287,0.484,126,371,0.34,497,916,0.543,0.533,340,392,0.867,34,247,281,289,53,16,207,181,1712
Deandre Ayton,10018200,P,22,PHO,69,69,2115,430,687,0.626,4,20,0.2,426,667,0.639,0.629,133,173,0.769,228,499,727,99,41,81,103,196,997
Jae Crowder,9258000,AP,30,PHO,60,42,1648,199,492,0.404,148,380,0.389,51,112,0.455,0.555,57,75,0.76,32,250,282,127,48,27,55,125,603
Dario Šarić,9250000,P,26,PHO,50,4,871,153,342,0.447,47,135,0.348,106,207,0.512,0.516,84,99,0.848,46,144,190,65,30,4,57,95,437
Mikal Bridges,4359000,AL,24,PHO,72,72,2348,363,669,0.543,134,315,0.425,229,354,0.647,0.643,110,131,0.84,76,233,309,152,76,63,57,116,970
Jalen Smith,4245720,AP,20,PHO,27,1,156,22,50,0.44,4,17,0.235,18,33,0.545,0.48,5,7,0.714,7,30,37,4,1,5,7,16,53
Cameron Johnson,4235160,AP,24,PHO,60,11,1437,203,483,0.42,117,335,0.349,86,148,0.581,0.541,50,59,0.847,33,166,199,86,37,16,40,85,573
Jevon Carter,3925000,BA,25,PHO,60,1,717,94,223,0.422,56,151,0.371,38,72,0.528,0.547,4,7,0.571,16,76,92,71,29,9,16,56,248
Cameron Payne,1977011,BA,26,PHO,60,1,1079,191,395,0.484,73,166,0.44,118,229,0.515,0.576,50,56,0.893,16,128,144,217,36,16,60,97,505
Abdel Nader,1752950,AL,27,PHO,24,0,355,57,116,0.491,18,43,0.419,39,73,0.534,0.569,28,37,0.757,7,55,62,19,10,9,19,34,160
Langston Galloway,1620564,ES,29,PHO,40,0,438,66,147,0.449,36,85,0.424,30,62,0.484,0.571,22,23,0.957,7,35,42,26,8,0,13,25,190
Frank Kaminsky,1620564,P,27,PHO,47,13,715,121,257,0.471,31,85,0.365,90,172,0.523,0.531,37,60,0.617,36,152,188,79,14,17,22,70,310
E'Twaun Moore,1620564,ES,31,PHO,27,1,389,55,121,0.455,11,35,0.314,44,86,0.512,0.5,12,14,0.857,14,31,45,40,15,5,23,32,133
Torrey Craig,1620564,AL,30,TOT,50,8,803,109,227,0.48,39,106,0.368,70,121,0.579,0.566,17,22,0.773,57,140,197,49,28,26,25,83,274
Buddy Hield,24701834,ES,28,SAC,71,71,2433,403,992,0.406,282,721,0.391,121,271,0.446,0.548,88,104,0.846,29,305,334,257,63,30,130,175,1176
Harrison Barnes,22215909,AP,28,SAC,58,58,2102,319,642,0.497,100,256,0.391,219,386,0.567,0.575,195,235,0.83,64,321,385,201,43,11,93,75,933
Delon Wright,9000000,BA,28,TOT,63,39,1748,240,518,0.463,64,172,0.372,176,346,0.509,0.525,101,126,0.802,65,204,269,278,101,30,83,75,645
De'Aaron Fox,8099627,BA,23,SAC,58,58,2036,529,1110,0.477,103,320,0.322,426,790,0.539,0.523,300,417,0.719,33,170,203,417,87,27,174,170,1461
Jabari Parker,6500000,AP,25,TOT,13,0,165,30,55,0.545,2,11,0.182,28,44,0.636,0.564,10,13,0.769,10,32,42,11,1,5,10,13,72
Jabari Parker,430729,AP,25,TOT,13,0,165,30,55,0.545,2,11,0.182,28,44,0.636,0.564,10,13,0.769,10,32,42,11,1,5,10,13,72
Richaun Holmes,5005350,P,27,SAC,61,61,1782,366,575,0.637,2,11,0.182,364,564,0.645,0.638,135,170,0.794,144,360,504,101,39,96,75,213,869
Tyrese Haliburton,3831840,BA,20,SAC,58,20,1746,292,619,0.472,121,296,0.409,171,323,0.529,0.569,48,56,0.857,39,134,173,309,77,28,92,83,753
Maurice Harkless,3623000,AP,27,TOT,37,23,772,69,165,0.418,23,84,0.274,46,81,0.568,0.488,33,43,0.767,13,76,89,44,30,20,22,86,194
Mfiondu Kabengele,2075880,AP,23,TOT,39,0,280,33,89,0.371,13,50,0.26,20,39,0.513,0.444,16,20,0.8,12,48,60,17,8,13,15,36,95
Mfiondu Kabengele,356473,AP,23,TOT,39,0,280,33,89,0.371,13,50,0.26,20,39,0.513,0.444,16,20,0.8,12,48,60,17,8,13,15,36,95
Hassan Whiteside,1620564,P,31,SAC,36,4,546,126,224,0.563,0,1,0.0,126,223,0.565,0.563,41,79,0.519,61,154,215,20,9,46,40,73,293
Terence Davis,1517981,ES,23,TOT,61,4,1074,195,456,0.428,98,267,0.367,97,189,0.513,0.535,45,55,0.818,20,134,154,83,44,14,63,97,533
Justin James,1517981,AL,24,SAC,36,0,310,52,111,0.468,14,38,0.368,38,73,0.521,0.532,21,36,0.583,9,21,30,22,8,3,15,23,139
Chris Silva,1517981,AP,24,TOT,15,0,92,10,16,0.625,1,1,1.0,9,15,0.6,0.656,11,15,0.733,7,20,27,6,1,6,10,24,32
Jahmi'us Ramsey,1000000,ES,19,SAC,13,0,94,15,38,0.395,5,19,0.263,10,19,0.526,0.461,5,5,1.0,2,8,10,6,4,1,3,8,40
Chimezie Metu,750000,P,23,SAC,36,6,488,91,179,0.508,13,37,0.351,78,142,0.549,0.545,31,43,0.721,31,81,112,28,14,18,29,59,226
Jonas Valančiūnas,15000000,P,28,MEM,62,61,1755,440,743,0.592,21,57,0.368,419,686,0.611,0.606,157,203,0.773,253,523,776,112,35,57,100,179,1058
Justise Winslow,13000000,AL,24,MEM,26,1,507,74,210,0.352,10,54,0.185,64,156,0.41,0.376,20,35,0.571,18,100,118,50,15,12,37,47,178
Dillon Brooks,11400000,AL,25,MEM,67,67,1997,432,1031,0.419,128,372,0.344,304,659,0.461,0.481,159,195,0.815,53,143,196,157,78,26,119,237,1151
De'Anthony Melton,9571712,BA,22,MEM,52,1,1045,172,393,0.438,87,211,0.412,85,182,0.467,0.548,41,51,0.804,30,131,161,132,60,31,66,85,472
Kyle Anderson,9505100,AP,27,MEM,69,69,1887,308,658,0.468,94,261,0.36,214,397,0.539,0.54,144,184,0.783,52,344,396,250,84,57,86,120,854
Ja Morant,9166800,BA,21,MEM,63,63,2053,430,957,0.449,73,241,0.303,357,716,0.499,0.487,271,372,0.728,59,193,252,465,57,13,203,87,1204
Tyus Jones,7965100,BA,24,MEM,70,9,1222,178,413,0.431,45,140,0.321,133,273,0.487,0.485,41,45,0.911,21,119,140,259,64,6,48,31,442
Brandon Clarke,2602920,AP,24,MEM,59,16,1415,256,495,0.517,20,77,0.26,236,418,0.565,0.537,78,113,0.69,97,231,328,95,60,51,33,84,610
Grayson Allen,2545320,ES,25,MEM,50,38,1259,173,414,0.418,107,274,0.391,66,140,0.471,0.547,79,91,0.868,19,141,160,108,46,8,48,71,532
John Konchar,2100000,ES,24,MEM,43,0,575,69,138,0.5,21,56,0.375,48,82,0.585,0.576,25,30,0.833,35,93,128,47,30,9,18,40,184
Desmond Bane,1936440,ES,22,MEM,68,17,1519,234,499,0.469,117,271,0.432,117,228,0.513,0.586,40,49,0.816,31,179,210,118,41,16,59,125,625
Jontay Porter,1900000,AP,21,MEM,11,0,54,8,15,0.533,3,8,0.375,5,7,0.714,0.633,3,5,0.6,4,10,14,1,3,1,7,12,22
Tim Frazier,518612,BA,30,MEM,5,0,62,3,20,0.15,0,8,0.0,3,12,0.25,0.15,2,6,0.333,0,8,8,16,2,1,4,7,8
Nikola Jokić,29542010,P,25,DEN,72,72,2488,732,1293,0.566,92,237,0.388,640,1056,0.606,0.602,342,394,0.868,205,575,780,599,95,48,222,192,1898
Jamal Murray,27285000,BA,23,DEN,48,48,1704,378,792,0.477,129,316,0.408,249,476,0.523,0.559,133,153,0.869,37,157,194,231,64,13,108,95,1018
Aaron Gordon,18136364,AP,25,TOT,50,50,1384,231,499,0.463,59,176,0.335,172,323,0.533,0.522,97,149,0.651,77,207,284,161,33,34,97,89,618
Will Barton,13723214,AL,30,DEN,56,52,1736,259,608,0.426,98,257,0.381,161,351,0.459,0.507,95,121,0.785,39,187,226,181,50,23,96,95,711
Paul Millsap,10000000,AP,35,DEN,56,36,1162,191,401,0.476,49,143,0.343,142,258,0.55,0.537,71,98,0.724,76,186,262,98,51,36,51,111,502
JaMychal Green,7199760,AP,30,DEN,58,5,1120,173,374,0.463,79,198,0.399,94,176,0.534,0.568,46,57,0.807,85,192,277,53,26,22,53,144,471
JaVale McGee,4200000,P,33,TOT,46,2,678,144,282,0.511,5,24,0.208,139,258,0.539,0.52,44,67,0.657,77,162,239,39,19,54,60,121,337
Facundo Campazzo,3100000,BA,29,DEN,65,19,1425,120,315,0.381,76,216,0.352,44,99,0.444,0.502,80,91,0.879,22,112,134,232,79,14,73,132,396
Zeke Nnaji,2379840,AP,20,DEN,42,1,397,50,104,0.481,24,59,0.407,26,45,0.578,0.596,12,15,0.8,14,51,65,10,8,4,7,29,136
Bol Bol,2058240,AP,21,DEN,32,2,160,25,58,0.431,9,24,0.375,16,34,0.471,0.509,10,15,0.667,0,24,24,7,3,10,13,14,69
Gary Clark,2000000,AP,26,TOT,39,11,654,40,132,0.303,31,108,0.287,9,24,0.375,0.42,8,10,0.8,33,82,115,31,13,7,17,35,119
PJ Dozier,1762796,ES,24,DEN,50,6,1088,148,355,0.417,47,149,0.315,101,206,0.49,0.483,42,66,0.636,35,147,182,92,31,22,46,86,385
Monte Morris,1723707,BA,25,DEN,47,13,1196,186,387,0.481,51,134,0.381,135,253,0.534,0.547,58,73,0.795,11,85,96,150,34,13,34,48,481
Vlatko Čančar,1517981,AP,23,DEN,41,1,281,33,72,0.458,9,33,0.273,24,39,0.615,0.521,10,13,0.769,11,39,50,14,11,2,14,18,85
Blake Griffin,32670565,AP,31,TOT,46,30,1186,174,411,0.423,70,205,0.341,104,206,0.505,0.509,87,117,0.744,35,190,225,140,32,15,62,111,505
Blake Griffin,776983,AP,31,TOT,46,30,1186,174,411,0.423,70,205,0.341,104,206,0.505,0.509,87,117,0.744,35,190,225,140,32,15,62,111,505
Jerami Grant,19050000,AL,26,DET,54,54,1829,400,932,0.429,115,329,0.35,285,603,0.473,0.491,290,343,0.845,35,215,250,152,35,58,109,125,1205
Cory Joseph,12600000,BA,29,TOT,63,13,1446,200,426,0.469,45,132,0.341,155,294,0.527,0.522,72,88,0.818,35,124,159,213,61,18,79,139,517
Mason Plumlee,8000000,P,30,DET,56,56,1499,234,381,0.614,0,7,0.0,234,374,0.626,0.614,113,169,0.669,145,374,519,202,43,50,105,186,581
Killian Hayes,5307120,BA,19,DET,26,18,670,71,201,0.353,20,72,0.278,51,129,0.395,0.403,14,17,0.824,6,63,69,138,27,10,83,57,176
Rodney McGruder,5192307,ES,29,DET,16,2,194,37,70,0.529,11,24,0.458,26,46,0.565,0.607,6,8,0.75,8,14,22,16,8,1,7,12,91
Josh Jackson,4767000,ES,23,DET,62,25,1560,296,707,0.419,77,257,0.3,219,450,0.487,0.473,159,218,0.729,57,197,254,143,53,47,142,178,828
Sekou Doumbouya,3449400,AP,20,DET,56,11,869,107,282,0.379,26,115,0.226,81,167,0.485,0.426,45,64,0.703,39,104,143,47,24,9,44,94,285
Isaiah Stewart,3121080,P,19,DET,68,14,1455,226,409,0.553,21,63,0.333,205,346,0.592,0.578,64,92,0.696,159,294,453,59,39,86,67,184,537
Dewayne Dedmon,2866667,P,31,MIA,16,0,210,46,65,0.708,1,5,0.2,45,60,0.75,0.715,20,27,0.741,28,58,86,12,9,6,13,36,113
Dewayne Dedmon,432890,P,31,MIA,16,0,210,46,65,0.708,1,5,0.2,45,60,0.75,0.715,20,27,0.741,28,58,86,12,9,6,13,36,113
Saddiq Bey,2689920,AL,21,DET,70,53,1909,279,691,0.404,175,460,0.38,104,231,0.45,0.53,124,147,0.844,43,275,318,95,52,14,60,110,857
Wayne Ellington,2564753,ES,33,DET,46,31,1012,149,338,0.441,116,275,0.422,33,63,0.524,0.612,28,35,0.8,12,73,85,67,18,9,33,59,442
Wayne Ellington,1000000,ES,33,DET,46,31,1012,149,338,0.441,116,275,0.422,33,63,0.524,0.612,28,35,0.8,12,73,85,67,18,9,33,59,442
Jahlil Okafor,1882867,P,25,DET,27,2,347,63,102,0.618,2,9,0.222,61,93,0.656,0.627,17,24,0.708,23,43,66,13,6,5,21,39,145
Hamidou Diallo,1663861,AL,22,TOT,52,9,1226,224,470,0.477,28,82,0.341,196,388,0.505,0.506,128,200,0.64,59,213,272,101,41,24,76,134,604
Deividas Sirvydis,898310,ES,20,DET,20,0,133,14,40,0.35,10,28,0.357,4,12,0.333,0.475,3,6,0.5,0,29,29,5,2,0,5,9,41
Tyler Cook,594121,AP,23,TOT,32,1,438,69,103,0.67,1,2,0.5,68,101,0.673,0.675,17,35,0.486,28,67,95,17,8,2,21,35,156
Tyler Cook,99020,AP,23,TOT,32,1,438,69,103,0.67,1,2,0.5,68,101,0.673,0.675,17,35,0.486,28,67,95,17,8,2,21,35,156
Gordon Hayward,28500000,AL,30,CHO,44,44,1496,311,658,0.473,85,205,0.415,226,453,0.499,0.537,156,185,0.843,37,221,258,181,52,14,91,74,863
Terry Rozier,18900000,ES,26,CHO,69,69,2383,510,1134,0.45,222,571,0.389,288,563,0.512,0.548,165,202,0.817,47,255,302,293,87,26,128,119,1407
Cody Zeller,15415730,P,28,CHO,48,21,1005,181,324,0.559,4,28,0.143,177,296,0.598,0.565,85,119,0.714,119,209,328,86,27,17,51,121,451
LaMelo Ball,7839960,BA,19,CHO,51,31,1469,293,672,0.436,92,261,0.352,201,411,0.489,0.504,125,165,0.758,63,239,302,313,81,18,145,136,803
Malik Monk,5345687,ES,22,CHO,42,0,878,173,399,0.434,85,212,0.401,88,187,0.471,0.54,59,72,0.819,14,87,101,87,19,4,55,47,490
P.J. Washington,4023600,AP,22,CHO,64,61,1954,302,686,0.44,112,290,0.386,190,396,0.48,0.522,108,145,0.745,93,325,418,161,69,79,128,171,824
Miles Bridges,3934320,AP,22,CHO,66,19,1932,313,622,0.503,116,290,0.4,197,332,0.593,0.596,98,113,0.867,81,316,397,147,44,52,106,143,840
Bismack Biyombo,3500000,P,28,CHO,66,36,1349,142,242,0.587,0,1,0.0,142,241,0.589,0.587,47,105,0.448,137,210,347,81,17,74,71,141,331
Brad Wanamaker,2250000,BA,31,TOT,61,0,1053,115,299,0.385,16,85,0.188,99,214,0.463,0.411,90,101,0.891,18,87,105,174,43,11,71,94,336
Devonte' Graham,1663861,BA,25,CHO,55,44,1659,252,669,0.377,179,477,0.375,73,192,0.38,0.51,133,158,0.842,22,126,148,295,48,6,84,77,816
Caleb Martin,1517981,AL,25,CHO,53,3,818,96,256,0.375,31,125,0.248,65,131,0.496,0.436,41,64,0.641,31,110,141,67,37,12,33,62,264
Cody Martin,1517981,AL,25,CHO,52,10,849,83,188,0.441,16,58,0.276,67,130,0.515,0.484,25,43,0.581,52,109,161,86,37,12,40,52,207
Jalen McDaniels,1517981,AL,23,CHO,47,18,904,133,284,0.468,35,105,0.333,98,179,0.547,0.53,45,64,0.703,45,124,169,53,28,19,45,95,346
Nick Richards,1000000,AP,23,CHO,18,0,63,4,9,0.444,0,1,0.0,4,8,0.5,0.444,7,11,0.636,4,7,11,2,0,0,3,7,15
Gary Harris,19160714,ES,26,TOT,39,38,1080,138,345,0.4,48,141,0.34,90,204,0.441,0.47,64,78,0.821,21,58,79,78,28,11,37,71,388
Terrence Ross,13500000,ES,29,ORL,46,2,1347,254,616,0.412,89,264,0.337,165,352,0.469,0.485,120,138,0.87,15,143,158,108,47,21,74,88,717
Markelle Fultz,12288697,BA,22,ORL,8,8,215,41,104,0.394,4,16,0.25,37,88,0.42,0.413,17,19,0.895,5,20,25,43,8,2,18,18,103
Michael Carter-Williams,3300000,ES,29,ORL,31,25,800,105,270,0.389,15,61,0.246,90,209,0.431,0.417,49,80,0.613,39,100,139,129,25,17,69,81,274
Cole Anthony,3285120,BA,20,ORL,47,34,1273,219,552,0.397,58,172,0.337,161,380,0.424,0.449,109,131,0.832,38,183,221,192,30,18,106,98,605
Chuma Okeke,3121080,AP,22,ORL,45,19,1133,135,324,0.417,49,141,0.348,86,183,0.47,0.492,30,40,0.75,42,139,181,101,48,22,38,48,349
Khem Birch,2586036,P,28,TOT,67,22,1529,189,380,0.497,13,52,0.25,176,328,0.537,0.514,91,129,0.705,174,213,387,89,48,50,44,113,482
Khem Birch,410691,P,28,TOT,67,22,1529,189,380,0.497,13,52,0.25,176,328,0.537,0.514,91,129,0.705,174,213,387,89,48,50,44,113,482
R.J. Hampton,2193480,ES,19,TOT,51,1,888,136,313,0.435,27,87,0.31,109,226,0.482,0.478,55,82,0.671,29,150,179,87,21,10,53,61,354
Dwayne Bacon,1678854,ES,25,ORL,72,50,1853,292,726,0.402,59,207,0.285,233,519,0.449,0.443,145,176,0.824,31,193,224,93,45,5,46,103,788
Jeff Teague,1620564,BA,32,TOT,55,7,950,123,284,0.433,36,82,0.439,87,202,0.431,0.496,89,105,0.848,15,73,88,132,34,12,64,56,371
Jeff Teague,510589,BA,32,TOT,55,7,950,123,284,0.433,36,82,0.439,87,202,0.431,0.496,89,105,0.848,15,73,88,132,34,12,64,56,371
Moritz Wagner,221995,P,23,TOT,45,24,722,104,229,0.454,31,91,0.341,73,138,0.529,0.522,71,87,0.816,27,119,146,50,26,18,43,108,310
Moritz Wagner,2161920,P,23,TOT,45,24,722,104,229,0.454,31,91,0.341,73,138,0.529,0.522,71,87,0.816,27,119,146,50,26,18,43,108,310
Robert Franks,198040,AP,24,ORL,7,0,101,13,28,0.464,5,15,0.333,8,13,0.615,0.554,12,13,0.923,6,8,14,5,3,3,2,8,43
Ignas Brazdeikis,148530,AL,22,TOT,13,0,249,35,83,0.422,11,28,0.393,24,55,0.436,0.488,10,14,0.714,11,34,45,17,4,3,12,22,91
Ignas Brazdeikis,1517981,AL,22,TOT,13,0,249,35,83,0.422,11,28,0.393,24,55,0.436,0.488,10,14,0.714,11,34,45,17,4,3,12,22,91
Devin Cannady,61528,BA,24,ORL,8,0,74,11,28,0.393,6,16,0.375,5,12,0.417,0.5,6,7,0.857,0,5,5,1,5,1,2,9,34
Russell Westbrook,41358814,BA,32,WAS,65,65,2369,544,1238,0.439,86,273,0.315,458,965,0.475,0.474,271,413,0.656,109,641,750,763,89,23,312,190,1445
Bradley Beal,28751774,ES,27,WAS,60,60,2147,670,1382,0.485,130,373,0.349,540,1009,0.535,0.532,408,459,0.889,72,211,283,265,69,22,187,140,1878
Dāvis Bertāns,15000000,AP,28,WAS,57,7,1464,193,478,0.404,169,428,0.395,24,50,0.48,0.581,100,115,0.87,18,150,168,49,33,13,33,136,655
Thomas Bryant,8333333,P,23,WAS,10,10,271,59,91,0.648,9,21,0.429,50,70,0.714,0.698,16,24,0.667,18,43,61,15,4,8,11,31,143
Robin Lopez,7300000,P,32,WAS,71,9,1354,269,425,0.633,5,18,0.278,264,407,0.649,0.639,99,137,0.723,141,131,272,55,15,44,75,109,642
Ish Smith,6000000,BA,32,WAS,44,1,924,129,297,0.434,18,49,0.367,111,248,0.448,0.465,19,33,0.576,22,128,150,172,32,13,41,62,295
Rui Hachimura,4692840,AP,22,WAS,57,57,1797,310,648,0.478,45,137,0.328,265,511,0.519,0.513,124,161,0.77,49,263,312,82,44,7,68,120,789
Deni Avdija,4469160,AL,20,WAS,54,32,1257,130,312,0.417,53,168,0.315,77,144,0.535,0.502,29,45,0.644,22,240,262,63,32,15,33,140,342
Jerome Robinson,3737520,ES,23,WAS,17,6,305,28,95,0.295,11,42,0.262,17,53,0.321,0.353,16,20,0.8,4,34,38,25,12,6,19,31,83
Chandler Hutchison,2443440,AL,24,TOT,25,1,346,39,103,0.379,8,22,0.364,31,81,0.383,0.417,21,25,0.84,6,72,78,17,12,5,20,33,107
Isaac Bonga,1663861,AL,21,WAS,40,8,432,30,81,0.37,13,47,0.277,17,34,0.5,0.451,5,8,0.625,18,48,66,23,11,9,22,63,78
Raul Neto,1620564,BA,28,WAS,64,22,1403,209,447,0.468,64,164,0.39,145,283,0.512,0.539,75,85,0.882,28,128,156,146,73,6,53,109,557
Alex Len,1265372,P,27,TOT,64,42,979,171,278,0.615,8,25,0.32,163,253,0.644,0.629,73,116,0.629,78,182,260,49,20,64,55,127,423
Alex Len,2258000,P,27,TOT,64,42,979,171,278,0.615,8,25,0.32,163,253,0.644,0.629,73,116,0.629,78,182,260,49,20,64,55,127,423
Anthony Gill,898310,AP,28,WAS,26,4,218,30,60,0.5,7,24,0.292,23,36,0.639,0.558,13,16,0.813,16,35,51,11,10,4,8,27,80
Malcolm Brogdon,20700000,BA,28,IND,56,56,1930,444,980,0.453,145,374,0.388,299,606,0.493,0.527,153,177,0.864,58,236,294,329,49,15,115,110,1186
Domantas Sabonis,19800000,AP,24,IND,62,62,2231,484,904,0.535,52,162,0.321,432,742,0.582,0.564,240,328,0.732,150,592,742,415,76,33,213,203,1260
Myles Turner,17500000,P,24,IND,47,47,1455,206,432,0.477,69,206,0.335,137,226,0.606,0.557,111,142,0.782,63,243,306,48,40,159,67,165,592
Caris LeVert,16203704,ES,26,TOT,47,39,1486,359,814,0.441,84,258,0.326,275,556,0.495,0.493,146,180,0.811,33,181,214,245,66,30,102,105,948
T.J. Warren,12000000,AL,27,IND,4,4,117,27,51,0.529,0,7,0.0,27,44,0.614,0.529,8,10,0.8,2,12,14,5,2,0,4,16,62
Jeremy Lamb,10500000,ES,28,IND,36,8,765,120,276,0.435,52,128,0.406,68,148,0.459,0.529,71,75,0.947,25,106,131,53,34,23,22,72,363
Doug McDermott,7333333,AP,29,IND,66,29,1619,354,665,0.532,111,286,0.388,243,379,0.641,0.616,80,98,0.816,60,161,221,85,20,6,53,117,899
Justin Holiday,5720400,ES,31,IND,72,52,2183,258,625,0.413,173,453,0.382,85,172,0.494,0.551,67,85,0.788,32,224,256,119,74,41,54,135,756
T.J. McConnell,3500000,BA,28,IND,69,3,1796,274,490,0.559,15,48,0.313,259,442,0.586,0.574,33,48,0.688,55,201,256,456,128,23,135,113,596
Goga Bitadze,2957520,P,21,IND,45,3,561,83,194,0.428,20,79,0.253,63,115,0.548,0.479,45,61,0.738,60,90,150,37,9,60,17,94,231
Aaron Holiday,2345640,BA,24,IND,66,8,1176,170,436,0.39,67,182,0.368,103,254,0.406,0.467,68,83,0.819,15,74,89,123,46,13,66,94,475
Edmond Sumner,2160000,ES,25,IND,53,24,861,148,282,0.525,35,88,0.398,113,194,0.582,0.587,68,83,0.819,18,76,94,49,33,10,51,88,399
JaKarr Sampson,1620564,AP,27,IND,29,4,316,56,113,0.496,3,15,0.2,53,98,0.541,0.509,19,29,0.655,27,50,77,4,2,14,15,52,134
Jalen Lecque,1517981,BA,20,IND,4,0,12,1,9,0.111,0,1,0.0,1,8,0.125,0.111,3,3,1.0,2,3,5,2,0,0,0,0,5
Oshae Brissett,955493,AL,22,IND,21,16,519,73,151,0.483,33,78,0.423,40,73,0.548,0.593,50,65,0.769,29,86,115,18,19,20,10,32,229
Oshae Brissett,300000,AL,22,IND,21,16,519,73,151,0.483,33,78,0.423,40,73,0.548,0.593,50,65,0.769,29,86,115,18,19,20,10,32,229
Kelan Martin,801900,AL,25,IND,35,0,322,62,138,0.449,24,60,0.4,38,78,0.487,0.536,9,10,0.9,18,60,78,17,10,10,16,35,157
Nikola Vučević,26000000,P,30,TOT,70,70,2348,666,1396,0.477,176,440,0.4,490,956,0.513,0.54,131,156,0.84,146,671,817,269,65,48,126,137,1639
Zach LaVine,19500000,ES,25,CHI,58,58,2034,569,1123,0.507,200,477,0.419,369,646,0.571,0.596,253,298,0.849,36,253,289,282,46,27,203,138,1591
Thaddeus Young,13545000,AP,32,CHI,68,23,1652,370,662,0.559,12,45,0.267,358,617,0.58,0.568,71,113,0.628,168,255,423,291,74,40,137,152,823
Tomáš Satoranský,10000000,ES,29,CHI,58,18,1307,169,329,0.514,42,118,0.356,127,211,0.602,0.578,67,79,0.848,30,112,142,271,40,14,96,89,447
Al-Farouq Aminu,9720900,AP,30,TOT,23,14,434,38,99,0.384,8,37,0.216,30,62,0.484,0.424,18,22,0.818,22,88,110,31,19,9,28,29,102
Cristiano Felício,7529020,P,28,CHI,18,0,84,7,13,0.538,0,2,0.0,7,11,0.636,0.538,9,16,0.563,10,16,26,9,4,0,4,10,23
Patrick Williams,7068360,AP,19,CHI,71,71,1983,255,528,0.483,54,138,0.391,201,390,0.515,0.534,91,125,0.728,66,261,327,99,64,46,98,126,655
Lauri Markkanen,6731508,AP,23,CHI,51,26,1317,250,521,0.48,119,296,0.402,131,225,0.582,0.594,76,92,0.826,35,233,268,45,26,15,52,75,695
Coby White,5572680,BA,20,CHI,69,54,2156,375,902,0.416,163,454,0.359,212,448,0.473,0.506,128,142,0.901,28,256,284,328,38,15,156,179,1041
Daniel Theis,5000000,P,28,TOT,65,51,1601,252,466,0.541,49,152,0.322,203,314,0.646,0.593,74,110,0.673,93,263,356,108,41,57,66,167,627
Garrett Temple,4767000,ES,34,CHI,56,25,1528,158,381,0.415,67,200,0.335,91,181,0.503,0.503,40,50,0.8,29,131,160,124,43,30,58,126,423
Denzel Valentine,4642800,ES,27,CHI,62,3,1036,155,416,0.373,80,242,0.331,75,174,0.431,0.469,16,17,0.941,24,173,197,105,30,7,42,70,406
Ryan Arcidiacono,3000000,BA,26,CHI,44,0,450,49,117,0.419,25,67,0.373,24,50,0.48,0.526,13,20,0.65,5,62,67,56,9,0,10,47,136
Javonte Green,1517981,ES,27,TOT,41,2,473,53,102,0.52,10,30,0.333,43,72,0.597,0.569,30,40,0.75,26,45,71,17,28,6,19,45,146
Pascal Siakam,30559200,AP,26,TOR,56,56,2006,437,961,0.455,73,246,0.297,364,715,0.509,0.493,249,301,0.827,95,310,405,250,64,37,130,174,1196
Kyle Lowry,30500000,BA,34,TOR,46,46,1601,260,596,0.436,131,331,0.396,129,265,0.487,0.546,140,160,0.875,35,212,247,338,45,14,126,143,791
Fred VanVleet,21250000,ES,26,TOR,52,52,1899,338,870,0.389,174,476,0.366,164,394,0.416,0.489,169,191,0.885,32,188,220,328,87,37,95,119,1019
Rodney Hood,10047450,AL,28,TOT,55,5,942,94,260,0.362,34,113,0.301,60,147,0.408,0.427,24,28,0.857,23,80,103,53,24,7,36,74,246
Aron Baynes,7000000,P,34,TOR,53,31,980,134,304,0.441,27,103,0.262,107,201,0.532,0.485,29,41,0.707,87,186,273,47,17,23,46,119,324
Chris Boucher,6500000,P,28,TOR,60,14,1453,288,560,0.514,90,235,0.383,198,325,0.609,0.595,152,193,0.788,117,287,404,63,35,111,46,166,818
OG Anunoby,3872215,AL,23,TOR,43,43,1433,249,519,0.48,104,261,0.398,145,258,0.562,0.58,80,102,0.784,54,183,237,94,66,32,75,114,682
Stanley Johnson,3804150,AP,24,TOR,61,13,1006,89,233,0.382,45,137,0.328,44,96,0.458,0.479,44,55,0.8,29,124,153,89,52,18,54,116,267
Malachi Flynn,1950600,BA,22,TOR,47,14,928,127,340,0.374,54,168,0.321,73,172,0.424,0.453,45,56,0.804,10,106,116,137,38,7,43,68,353
DeAndre' Bembry,1737145,AL,26,TOR,51,12,972,117,228,0.513,14,53,0.264,103,175,0.589,0.544,45,66,0.682,33,113,146,107,53,18,71,87,293
Paul Watson,1445697,AL,26,TOR,27,2,297,38,82,0.463,30,64,0.469,8,18,0.444,0.646,5,8,0.625,4,41,45,17,6,3,9,36,111
Yuta Watanabe,321893,AL,26,TOR,50,4,723,79,180,0.439,36,90,0.4,43,90,0.478,0.539,24,29,0.828,36,123,159,40,26,19,19,57,218
Henry Ellenson,160998,AP,24,TOR,2,0,38,5,14,0.357,2,9,0.222,3,5,0.6,0.429,3,4,0.75,3,9,12,5,0,0,0,7,15
Danilo Gallinari,19500000,AP,32,ATL,51,4,1222,206,475,0.434,103,254,0.406,103,221,0.466,0.542,161,174,0.925,17,194,211,76,30,10,43,105,676
Bogdan Bogdanović,18000000,ES,28,ATL,44,27,1305,267,565,0.473,146,333,0.438,121,232,0.522,0.602,40,44,0.909,20,140,160,147,49,13,54,99,720
Tony Snell,12178571,ES,29,ATL,47,23,992,88,171,0.515,62,109,0.569,26,62,0.419,0.696,11,11,1.0,18,94,112,59,13,11,21,75,249
Lou Williams,8000000,BA,34,TOT,66,4,1423,265,646,0.41,69,173,0.399,196,473,0.414,0.464,150,173,0.867,21,117,138,225,47,6,108,62,749
De'Andre Hunter,7422000,AL,23,ATL,23,19,678,120,248,0.484,31,95,0.326,89,153,0.582,0.546,73,85,0.859,17,93,110,44,19,12,29,59,344
Trae Young,6571800,BA,22,ATL,63,63,2125,487,1112,0.438,136,397,0.343,351,715,0.491,0.499,484,546,0.886,38,207,245,594,53,12,261,111,1594
Onyeka Okongwu,5813640,P,20,ATL,50,4,601,96,149,0.644,0,3,0.0,96,146,0.658,0.644,36,57,0.632,62,101,163,18,23,33,29,100,228
Kris Dunn,4767000,BA,26,ATL,4,0,45,1,12,0.083,0,2,0.0,1,10,0.1,0.083,3,4,0.75,0,6,6,2,2,2,3,10,5
Cam Reddish,4458000,AL,21,ATL,26,21,750,96,263,0.365,33,126,0.262,63,137,0.46,0.428,67,82,0.817,22,82,104,35,33,9,34,68,292
John Collins,4137302,AP,23,ATL,63,63,1848,429,771,0.556,83,208,0.399,346,563,0.615,0.61,170,204,0.833,118,349,467,78,34,63,84,193,1111
Kevin Huerter,2761920,ES,22,ATL,69,49,2126,316,731,0.432,140,386,0.363,176,345,0.51,0.528,50,64,0.781,38,193,231,241,82,18,79,165,822
Brandon Goodwin,1701593,BA,25,ATL,47,5,620,84,223,0.377,32,103,0.311,52,120,0.433,0.448,28,43,0.651,8,61,69,95,17,0,36,41,228
Solomon Hill,1620564,AP,29,ATL,71,16,1513,107,298,0.359,68,212,0.321,39,86,0.453,0.473,35,46,0.761,42,172,214,75,50,11,42,116,317
Bruno Fernando,1517981,P,22,ATL,33,0,226,18,44,0.409,0,2,0.0,18,42,0.429,0.409,15,22,0.682,16,62,78,10,4,3,21,23,51
Jimmy Butler,34379100,AL,31,MIA,52,52,1745,366,736,0.497,25,102,0.245,341,634,0.538,0.514,359,416,0.863,94,265,359,369,108,18,109,71,1116
Victor Oladipo,21000000,ES,28,TOT,33,33,1080,235,576,0.408,78,239,0.326,157,337,0.466,0.476,104,138,0.754,12,148,160,151,46,14,83,81,652
Goran Dragić,18000000,BA,34,MIA,50,11,1337,240,555,0.432,91,244,0.373,149,311,0.479,0.514,101,122,0.828,25,144,169,219,33,8,118,113,672
Andre Iguodala,15000000,AL,37,MIA,63,5,1339,95,248,0.383,60,182,0.33,35,66,0.53,0.504,25,38,0.658,38,183,221,142,57,35,67,90,275
Trevor Ariza,12800000,AL,35,MIA,30,27,841,99,241,0.411,50,143,0.35,49,98,0.5,0.515,34,44,0.773,27,117,144,55,31,18,21,55,282
Nemanja Bjelica,7150000,AP,32,TOT,37,3,595,89,196,0.454,27,85,0.318,62,111,0.559,0.523,37,51,0.725,29,98,127,69,15,5,33,68,242
Bam Adebayo,5115492,P,23,MIA,64,64,2143,456,800,0.57,2,8,0.25,454,792,0.573,0.571,283,354,0.799,142,431,573,346,75,66,169,145,1197
Tyler Herro,3822240,ES,21,MIA,54,15,1635,307,699,0.439,107,297,0.36,200,402,0.498,0.516,94,117,0.803,25,243,268,184,35,17,101,71,815
Precious Achiuwa,2582160,AP,21,MIA,61,4,737,124,228,0.544,0,1,0.0,124,227,0.546,0.544,56,110,0.509,73,135,208,29,20,28,43,91,304
Duncan Robinson,1663861,AL,26,MIA,72,72,2262,315,717,0.439,250,613,0.408,65,104,0.625,0.614,62,75,0.827,7,243,250,127,43,20,81,181,942
Kendrick Nunn,1663861,BA,25,MIA,56,44,1650,319,658,0.485,122,320,0.381,197,338,0.583,0.578,56,60,0.933,21,158,179,148,52,14,80,108,816
KZ Okpala,1517981,AP,21,MIA,37,9,447,36,96,0.375,12,50,0.24,24,46,0.522,0.438,8,15,0.533,21,47,68,19,10,11,15,59,92
James Harden,41254920,BA,31,TOT,44,43,1609,342,734,0.466,121,334,0.362,221,400,0.553,0.548,278,323,0.861,35,313,348,475,53,33,177,99,1083
Kevin Durant,39058950,AP,32,BRK,35,32,1157,324,603,0.537,85,189,0.45,239,414,0.577,0.608,210,238,0.882,13,234,247,195,25,45,120,70,943
Kyrie Irving,33460350,BA,28,BRK,54,54,1886,549,1086,0.506,152,378,0.402,397,708,0.561,0.576,201,218,0.922,52,205,257,324,76,37,130,140,1451
Joe Harris,16071429,AL,29,BRK,69,65,2141,357,707,0.505,211,444,0.475,146,263,0.555,0.654,49,63,0.778,43,205,248,130,46,14,62,141,974
Spencer Dinwiddie,11454048,ES,27,BRK,3,3,64,6,16,0.375,2,7,0.286,4,9,0.444,0.438,6,6,1.0,0,13,13,9,2,1,5,4,20
DeAndre Jordan,10375678,P,32,BRK,57,43,1246,190,249,0.763,0,1,0.0,190,248,0.766,0.763,46,92,0.5,117,310,427,93,17,65,85,116,426
Jeff Green,2564753,AP,34,BRK,68,38,1835,261,530,0.492,103,250,0.412,158,280,0.564,0.59,125,161,0.776,34,229,263,108,36,27,54,122,750
Landry Shamet,2090040,ES,23,BRK,61,12,1403,186,456,0.408,129,333,0.387,57,123,0.463,0.549,66,78,0.846,11,101,112,99,31,10,48,93,567
Timothé Luwawu-Cabarrot,1824003,AL,25,BRK,58,7,1050,130,356,0.365,75,239,0.314,55,117,0.47,0.471,35,43,0.814,28,101,129,69,33,6,43,99,370
Bruce Brown,1663861,BA,24,BRK,65,37,1451,235,423,0.556,17,59,0.288,218,364,0.599,0.576,86,117,0.735,111,238,349,104,58,28,54,145,573
Tyler Johnson,1620564,ES,28,BRK,39,3,684,72,183,0.393,48,132,0.364,24,51,0.471,0.525,18,21,0.857,6,71,77,47,14,0,17,43,210
Nic Claxton,1517981,P,21,BRK,32,1,594,90,145,0.621,1,5,0.2,89,140,0.636,0.624,31,64,0.484,43,123,166,28,23,40,18,68,212
Alize Johnson,621587,AP,24,BRK,18,0,189,40,68,0.588,1,6,0.167,39,62,0.629,0.596,13,13,1.0,27,63,90,14,5,5,9,16,94
Andre Roberson,274816,ES,29,BRK,5,0,63,2,14,0.143,1,8,0.125,1,6,0.167,0.179,1,2,0.5,7,8,15,4,3,1,2,4,6
Mike James,237648,BA,30,BRK,13,1,236,34,92,0.37,11,31,0.355,23,61,0.377,0.429,21,27,0.778,3,29,32,54,6,1,20,10,100
Kevin Love,31258256,AP,32,CLE,25,25,622,103,252,0.409,57,156,0.365,46,96,0.479,0.522,42,51,0.824,17,169,186,63,16,2,38,26,305
Taurean Prince,12250000,AP,26,TOT,41,10,905,131,327,0.401,62,155,0.4,69,172,0.401,0.495,65,76,0.855,19,123,142,76,28,23,47,75,389
Cedi Osman,8840580,AL,25,CLE,59,26,1510,219,586,0.374,99,324,0.306,120,262,0.458,0.458,76,95,0.8,38,163,201,174,53,9,80,119,613
Darius Garland,6720720,BA,21,CLE,54,50,1790,362,802,0.451,105,266,0.395,257,536,0.479,0.517,112,132,0.848,23,106,129,329,66,6,164,110,941
Isaac Okoro,6400920,ES,20,CLE,67,67,2173,235,559,0.42,62,214,0.29,173,345,0.501,0.476,114,157,0.726,68,138,206,128,62,24,86,185,646
Collin Sexton,4991880,ES,22,CLE,60,60,2115,525,1105,0.475,98,264,0.371,427,841,0.508,0.519,312,383,0.815,58,129,187,262,62,10,167,157,1460
Jarrett Allen,3909902,P,22,TOT,63,45,1864,298,482,0.618,6,19,0.316,292,463,0.631,0.624,204,290,0.703,196,435,631,106,32,90,100,96,806
Dylan Windler,2137440,AL,24,CLE,31,0,513,57,130,0.438,26,77,0.338,31,53,0.585,0.538,21,27,0.778,20,87,107,33,19,12,32,37,161
Damyean Dotson,2000000,ES,26,CLE,46,7,907,119,293,0.406,46,159,0.289,73,134,0.545,0.485,24,36,0.667,5,88,93,91,16,4,42,42,308
Matthew Dellavedova,1620564,BA,30,CLE,13,1,224,14,56,0.25,4,25,0.16,10,31,0.323,0.286,4,4,1.0,6,18,24,58,4,1,6,21,36
Isaiah Hartenstein,1620564,P,22,TOT,46,2,559,94,171,0.55,2,6,0.333,92,165,0.558,0.556,46,71,0.648,65,116,181,55,19,39,44,104,236
Dean Wade,1517981,AP,24,CLE,63,19,1212,134,311,0.431,78,213,0.366,56,98,0.571,0.556,30,39,0.769,38,177,215,74,35,21,30,78,376
Lamar Stevens,652366,AP,23,CLE,40,0,499,62,136,0.456,4,25,0.16,58,111,0.523,0.471,37,51,0.725,24,72,96,25,17,13,23,53,165
Rayjon Tucker,340000,BA,23,PHI,14,0,68,9,18,0.5,2,7,0.286,7,11,0.636,0.556,14,19,0.737,1,10,11,6,2,0,4,8,34
Thon Maker,309355,P,23,CLE,8,0,76,10,18,0.556,0,2,0.0,10,16,0.625,0.556,10,11,0.909,8,10,18,4,2,4,3,7,30
Khris Middleton,33051724,AL,29,MIL,68,68,2269,511,1074,0.476,151,365,0.414,360,709,0.508,0.546,212,236,0.898,54,352,406,370,74,9,178,160,1385
Giannis Antetokounmpo,27528088,AP,26,MIL,61,61,2013,626,1100,0.569,67,221,0.303,559,879,0.636,0.6,398,581,0.685,97,574,671,357,72,73,207,168,1717
Jrue Holiday,25876111,BA,30,MIL,59,56,1907,414,823,0.503,111,283,0.392,303,540,0.561,0.57,107,136,0.787,73,195,268,357,96,37,127,98,1046
Brook Lopez,12697675,P,32,MIL,70,70,1902,322,640,0.503,95,281,0.338,227,359,0.632,0.577,120,142,0.845,104,243,347,50,40,103,64,149,859
P.J. Tucker,7969537,AP,35,TOT,52,33,1356,66,177,0.373,40,119,0.336,26,58,0.448,0.486,21,28,0.75,51,153,204,61,39,20,40,125,193
Pat Connaughton,4938273,ES,28,MIL,69,4,1575,168,387,0.434,101,272,0.371,67,115,0.583,0.565,31,40,0.775,63,269,332,81,49,23,33,99,468
Bobby Portis,3623000,P,25,MIL,66,7,1372,313,598,0.523,74,157,0.471,239,441,0.542,0.585,54,73,0.74,124,342,466,71,52,26,56,115,754
Donte DiVincenzo,3044160,ES,24,MIL,66,66,1814,253,603,0.42,131,346,0.379,122,257,0.475,0.528,51,71,0.718,81,299,380,203,72,15,91,112,688
Bryn Forbes,2337145,ES,27,MIL,70,10,1354,250,529,0.473,154,341,0.452,96,188,0.511,0.618,47,61,0.77,11,101,112,45,24,1,44,77,701
Rodions Kurucs,1780152,AP,22,TOT,21,0,125,11,32,0.344,6,21,0.286,5,11,0.455,0.438,3,4,0.75,5,18,23,10,9,4,13,16,31
Thanasis Antetokounmpo,1701593,AL,28,MIL,57,3,551,67,137,0.489,7,29,0.241,60,108,0.556,0.515,25,49,0.51,54,70,124,46,22,10,43,74,166
Sam Merrill,898310,ES,24,MIL,30,2,233,32,72,0.444,21,47,0.447,11,25,0.44,0.59,4,4,1.0,6,24,30,21,8,1,10,17,89
Jordan Nwora,898310,AL,22,MIL,30,2,274,62,135,0.459,28,62,0.452,34,73,0.466,0.563,19,25,0.76,9,51,60,7,16,7,24,22,171
Mamadi Diakite,160173,AP,24,MIL,14,1,141,16,40,0.4,1,8,0.125,15,32,0.469,0.413,11,14,0.786,8,26,34,8,7,6,3,16,44
Elijah Bryant,24611,ES,25,MIL,1,0,32,6,13,0.462,1,5,0.2,5,8,0.625,0.5,3,3,1.0,2,4,6,3,0,1,4,4,16
Julius Randle,18900000,AP,26,NYK,71,71,2667,602,1321,0.456,160,389,0.411,442,932,0.474,0.516,348,429,0.811,84,639,723,427,64,18,241,225,1712
RJ Barrett,8231760,ES,20,NYK,72,72,2511,467,1060,0.441,124,309,0.401,343,751,0.457,0.499,206,276,0.746,68,346,414,217,53,20,139,188,1264
Derrick Rose,7682926,BA,32,TOT,50,3,1279,287,611,0.47,50,129,0.388,237,482,0.492,0.511,110,127,0.866,20,110,130,209,49,19,78,56,734
Frank Ntilikina,6176578,BA,22,NYK,33,4,322,29,79,0.367,23,48,0.479,6,31,0.194,0.513,8,18,0.444,6,25,31,19,18,4,11,45,89
Alec Burks,6000000,ES,29,NYK,49,5,1255,210,500,0.42,102,246,0.415,108,254,0.425,0.522,101,118,0.856,21,206,227,107,31,14,49,102,623
Elfrid Payton,5767000,BA,26,NYK,63,63,1484,269,622,0.432,28,98,0.286,241,524,0.46,0.455,73,107,0.682,64,152,216,203,47,9,103,116,639
Nerlens Noel,5000000,P,26,NYK,64,41,1547,137,223,0.614,0,3,0.0,137,220,0.623,0.614,50,70,0.714,142,266,408,46,70,141,65,176,324
Obi Toppin,4862040,AP,22,NYK,62,0,683,104,209,0.498,26,85,0.306,78,124,0.629,0.56,19,26,0.731,26,112,138,29,17,15,23,55,253
Kevin Knox,4588680,AL,21,NYK,42,0,464,56,143,0.392,35,89,0.393,21,54,0.389,0.514,16,20,0.8,10,51,61,19,12,6,17,37,163
Reggie Bullock,4200000,AL,29,NYK,65,64,1949,248,561,0.442,163,398,0.41,85,163,0.521,0.587,50,55,0.909,16,207,223,99,52,11,45,146,709
Vincent Poirier,2619207,P,27,PHI,10,0,39,3,12,0.25,0,1,0.0,3,11,0.273,0.25,2,6,0.333,6,8,14,2,0,3,4,8,8
Taj Gibson,2442968,P,35,NYK,45,3,936,99,158,0.627,3,15,0.2,96,143,0.671,0.636,40,55,0.727,99,151,250,36,31,49,22,99,241
Immanuel Quickley,2105520,BA,21,NYK,64,3,1243,229,580,0.395,118,303,0.389,111,277,0.401,0.497,155,174,0.891,25,112,137,127,30,12,58,114,731
Jared Harper,99020,BA,23,NYK,8,0,16,0,4,0.0,0,1,0.0,0,3,0.0,0.0,3,4,0.75,0,2,2,1,0,0,3,1,3
Tobias Harris,34358850,AP,28,PHI,62,62,2014,473,924,0.512,82,208,0.394,391,716,0.546,0.556,182,204,0.892,62,357,419,220,55,51,107,119,1210
Ben Simmons,30559200,BA,24,PHI,58,58,1877,325,583,0.557,3,10,0.3,322,573,0.562,0.56,176,287,0.613,93,324,417,401,93,35,173,171,829
Joel Embiid,29542010,P,26,PHI,51,51,1585,461,899,0.513,58,154,0.377,403,745,0.541,0.545,471,548,0.859,113,426,539,145,50,69,159,123,1451
Danny Green,15365853,AL,33,PHI,69,69,1934,224,544,0.412,175,432,0.405,49,112,0.438,0.573,31,40,0.775,55,205,260,118,92,56,67,125,654
George Hill,9590602,BA,34,TOT,30,17,672,95,197,0.482,31,80,0.388,64,117,0.547,0.561,40,50,0.8,16,45,61,73,23,5,31,31,261
Seth Curry,7834449,ES,30,PHI,57,57,1638,258,552,0.467,126,280,0.45,132,272,0.485,0.582,69,77,0.896,10,126,136,155,44,8,65,96,711
Mike Scott,5005350,AP,32,PHI,51,12,852,76,211,0.36,53,155,0.342,23,56,0.411,0.486,8,12,0.667,11,109,120,40,24,14,19,72,213
Matisse Thybulle,2711280,ES,23,PHI,65,8,1298,102,243,0.42,43,143,0.301,59,100,0.59,0.508,8,18,0.444,30,94,124,63,105,71,32,127,255
Tyrese Maxey,2478840,ES,20,PHI,61,8,935,198,429,0.462,31,103,0.301,167,326,0.512,0.498,61,70,0.871,11,93,104,120,26,13,41,79,488
Furkan Korkmaz,1762796,ES,23,PHI,55,11,1062,170,424,0.401,101,269,0.375,69,155,0.445,0.52,60,82,0.732,17,96,113,82,49,9,46,64,501
Shake Milton,1701593,ES,24,PHI,63,4,1461,300,667,0.45,71,203,0.35,229,464,0.494,0.503,146,176,0.83,33,115,148,193,39,18,103,130,817
Dwight Howard,1620564,P,35,PHI,69,6,1196,178,303,0.587,5,20,0.25,173,283,0.611,0.596,121,210,0.576,190,390,580,61,30,62,112,200,482
Isaiah Joe,898310,ES,21,PHI,41,1,383,48,133,0.361,39,106,0.368,9,27,0.333,0.508,18,24,0.75,6,30,36,20,12,4,11,34,153
Paul Reed,609128,AP,21,PHI,26,0,177,42,78,0.538,0,6,0.0,42,72,0.583,0.538,4,8,0.5,30,31,61,12,10,13,12,29,88
Anthony Tolliver,485498,AP,35,PHI,11,0,99,4,17,0.235,4,14,0.286,0,3,0.0,0.353,5,6,0.833,3,7,10,2,3,2,3,7,17
Kemba Walker,34379100,BA,30,BOS,43,43,1369,284,676,0.42,127,353,0.36,157,323,0.486,0.514,134,149,0.899,16,154,170,212,48,12,88,61,829
Jaylen Brown,23437500,ES,24,BOS,58,58,1999,538,1111,0.484,163,411,0.397,375,700,0.536,0.558,191,250,0.764,71,276,347,195,72,32,158,168,1430
Evan Fournier,17450000,AL,28,TOT,42,36,1259,247,541,0.457,117,283,0.413,130,258,0.504,0.565,108,137,0.788,10,118,128,144,47,19,73,96,719
Marcus Smart,13446428,BA,26,BOS,48,45,1581,203,510,0.398,93,282,0.33,110,228,0.482,0.489,128,162,0.79,36,131,167,273,72,23,96,126,627
Jayson Tatum,9897120,AL,22,BOS,64,64,2290,605,1318,0.459,187,485,0.386,418,833,0.502,0.53,295,340,0.868,50,422,472,276,75,31,171,122,1692
Tristan Thompson,9258000,P,29,BOS,54,43,1287,169,326,0.518,0,3,0.0,169,323,0.523,0.518,71,120,0.592,169,270,439,67,24,33,62,119,409
Romeo Langford,3631200,ES,21,BOS,18,4,283,21,59,0.356,5,18,0.278,16,41,0.39,0.398,9,12,0.75,12,23,35,13,6,5,10,24,56
Aaron Nesmith,3458400,AL,21,BOS,46,1,669,78,178,0.438,40,108,0.37,38,70,0.543,0.551,22,28,0.786,28,99,127,23,15,9,23,87,218
Grant Williams,2498760,AP,22,BOS,63,9,1138,108,247,0.437,48,129,0.372,60,118,0.508,0.534,30,51,0.588,48,130,178,64,32,24,56,161,294
Luke Kornet,2250000,P,25,TOT,31,2,348,44,101,0.436,15,59,0.254,29,42,0.69,0.51,3,6,0.5,14,53,67,24,4,32,7,20,106
Payton Pritchard,2035800,ES,23,BOS,66,4,1268,184,418,0.44,102,248,0.411,82,170,0.482,0.562,40,45,0.889,33,125,158,120,37,9,53,104,510
Robert Williams,2029920,P,23,BOS,52,13,985,186,258,0.721,0,2,0.0,186,256,0.727,0.721,45,73,0.616,133,225,358,94,43,91,52,105,417
Semi Ojeleye,1752950,AP,26,BOS,56,15,950,89,221,0.403,58,158,0.367,31,63,0.492,0.534,24,32,0.75,31,116,147,37,17,0,21,56,260
Carsen Edwards,1517981,ES,22,BOS,31,1,276,47,111,0.423,18,63,0.286,29,48,0.604,0.505,11,13,0.846,3,23,26,14,7,1,7,25,123
Aaron Gordon,16409091,AP,26,DEN,75,75,2376,434,834,0.52,87,260,0.335,347,574,0.605,0.573,171,230,0.743,125,314,439,188,44,44,133,148,1126
Aaron Holiday,3980551,BA,25,PHO,63,15,1021,151,338,0.447,39,103,0.379,112,235,0.477,0.504,59,68,0.868,24,98,122,153,42,9,67,92,400
Aaron Nesmith,3631200,AL,22,BOS,52,3,574,72,182,0.396,31,115,0.27,41,67,0.612,0.481,21,26,0.808,15,74,89,22,20,5,31,70,196
Aaron Wiggins,1000000,ES,23,OKC,50,35,1209,156,337,0.463,42,138,0.304,114,199,0.573,0.525,62,85,0.729,51,127,178,68,30,10,54,93,416
Abdel Nader,2000000,AL,28,PHO,14,0,145,12,35,0.343,4,14,0.286,8,21,0.381,0.4,6,10,0.6,4,23,27,7,8,4,11,20,34
Admiral Schofield,300000,AL,24,ORL,38,1,469,54,129,0.419,26,79,0.329,28,50,0.56,0.519,12,15,0.8,17,72,89,25,4,5,21,58,146
Al Horford,27000000,P,35,BOS,69,69,2005,266,569,0.467,89,265,0.336,177,304,0.582,0.546,80,95,0.842,108,422,530,232,49,92,65,130,701
Alec Burks,9536000,ES,30,NYK,81,44,2318,285,728,0.391,157,389,0.404,128,339,0.378,0.499,217,264,0.822,47,350,397,239,85,26,91,215,944
Aleksej Pokusevski,3113160,AP,20,OKC,61,12,1233,186,456,0.408,57,197,0.289,129,259,0.498,0.47,35,50,0.7,73,245,318,131,39,38,94,88,464
Alex Caruso,8600000,ES,27,CHI,41,18,1147,102,256,0.398,42,126,0.333,60,130,0.462,0.48,58,73,0.795,33,115,148,165,71,15,57,106,304
Alex Len,3732000,P,28,SAC,39,10,620,94,176,0.534,6,21,0.286,88,155,0.568,0.551,41,63,0.651,52,109,161,45,13,25,43,100,235
Alfonzo McKinnie,1254536,AL,29,CHI,17,3,206,24,61,0.393,9,27,0.333,15,34,0.441,0.467,2,8,0.25,13,20,33,5,2,3,7,26,59
Alize Johnson,1000000,AP,25,NOP,23,0,167,17,39,0.436,0,4,0.0,17,35,0.486,0.436,7,12,0.583,28,33,61,9,5,0,12,18,41
Alperen Şengün,3214680,P,19,HOU,72,13,1489,249,525,0.474,29,117,0.248,220,408,0.539,0.502,165,232,0.711,138,255,393,185,59,68,145,214,692
Amir Coffey,616117,ES,24,LAC,69,30,1567,211,466,0.453,96,254,0.378,115,212,0.542,0.556,101,117,0.863,26,171,197,124,38,15,45,87,619
Andre Drummond,2401537,P,28,BRK,73,36,1437,247,433,0.57,0,3,0.0,247,430,0.574,0.57,86,164,0.524,229,451,680,131,78,68,115,192,580
Andre Iguodala,2641691,AL,38,GSW,31,0,603,46,121,0.38,17,74,0.23,29,47,0.617,0.45,15,20,0.75,21,79,100,114,27,22,28,34,124
Andrew Wiggins,31579390,AL,26,GSW,73,73,2329,475,1019,0.466,157,399,0.393,318,620,0.513,0.543,149,235,0.634,85,240,325,161,76,51,111,158,1256
Anfernee Simons,3938818,ES,22,POR,57,30,1681,353,797,0.443,179,442,0.405,174,355,0.49,0.555,103,116,0.888,26,125,151,221,30,6,115,110,988
Anthony Davis,35361360,P,28,LAL,40,40,1404,370,695,0.532,13,70,0.186,357,625,0.571,0.542,174,244,0.713,106,288,394,122,49,90,82,97,927
Anthony Edwards,10245480,ES,20,MIN,72,72,2466,549,1245,0.441,215,602,0.357,334,643,0.519,0.527,220,280,0.786,62,281,343,275,105,46,190,164,1533
Anthony Gil,1517981,AP,29,WAS,44,0,463,62,109,0.569,14,26,0.538,48,83,0.578,0.633,42,52,0.808,33,52,85,27,5,11,18,58,180
Armoni Brooks,1800082,ES,23,TOR,54,11,844,98,289,0.339,74,249,0.297,24,40,0.6,0.467,18,21,0.857,20,83,103,62,28,11,27,74,288
Austin Reaves,925258,ES,23,LAL,61,19,1418,146,318,0.459,53,167,0.317,93,151,0.616,0.542,99,118,0.839,45,148,193,110,29,20,40,87,444
Austin Rivers,2389641,ES,29,DEN,67,18,1480,146,350,0.417,79,231,0.342,67,119,0.563,0.53,32,44,0.727,19,95,114,90,51,6,54,121,403
Avery Bradley,2641691,ES,31,LAL,62,45,1406,148,350,0.423,82,210,0.39,66,140,0.471,0.54,16,18,0.889,31,105,136,47,53,9,38,118,394
Ayo Dosunmu,925258,ES,22,CHI,77,40,2110,278,535,0.52,70,186,0.376,208,349,0.596,0.585,53,78,0.679,27,187,214,256,60,29,108,182,679
Bam Adebayo,28103500,P,24,MIA,56,56,1825,406,729,0.557,0,6,0.0,406,723,0.562,0.557,256,340,0.753,137,427,564,190,80,44,148,171,1068
Ben McLemore,2389641,ES,28,POR,64,6,1285,216,539,0.401,151,417,0.362,65,122,0.533,0.541,72,88,0.818,12,91,103,59,38,10,55,103,655
Blake Griffin,2641691,AP,32,BRK,56,24,958,133,313,0.425,38,145,0.262,95,168,0.565,0.486,55,76,0.724,60,168,228,105,27,14,31,95,359
Bojan Bogdanović,18700000,AP,32,UTA,69,69,2131,422,928,0.455,181,468,0.387,241,460,0.524,0.552,223,260,0.858,58,238,296,120,34,1,118,116,1248
Bol B,2161152,AP,22,DEN,14,0,81,15,27,0.556,1,4,0.25,14,23,0.609,0.574,2,5,0.4,4,16,20,5,1,2,4,4,33
Bones Hyland,2096880,BA,21,DEN,69,4,1310,230,571,0.403,131,358,0.366,99,213,0.465,0.518,107,125,0.856,14,174,188,191,41,20,86,153,698
Brad Wanamaker,900000,BA,32,WAS,23,2,320,28,77,0.364,4,17,0.235,24,60,0.4,0.39,23,25,0.92,6,33,39,55,7,6,23,45,83
Bradley Beal,33724200,ES,28,WAS,40,40,1439,348,771,0.451,63,210,0.3,285,561,0.508,0.492,169,203,0.833,38,151,189,265,36,15,135,95,928
Brandon Clarke,2726880,AP,25,MEM,64,1,1246,288,447,0.644,5,22,0.227,283,425,0.666,0.65,85,130,0.654,135,207,342,86,39,68,34,122,666
Brandon Goodwin,343988,BA,26,CLE,36,5,502,64,154,0.416,19,55,0.345,45,99,0.455,0.477,24,38,0.632,14,53,67,91,25,1,36,39,171
Brandon Ingram,29467800,AL,24,NOP,55,55,1869,453,983,0.461,74,226,0.327,379,757,0.501,0.498,266,322,0.826,35,285,320,307,34,26,151,119,1246
Brandon Knight,274672,BA,30,DAL,5,0,65,10,25,0.4,4,17,0.235,6,8,0.75,0.48,8,8,1.0,0,8,8,8,1,0,4,5,32
Braxton K,125446,AL,24,DET,11,0,197,33,72,0.458,6,21,0.286,27,51,0.529,0.5,7,13,0.538,13,37,50,11,10,11,11,26,79
Brook Lopez,13302325,P,33,MIL,13,11,298,61,131,0.466,19,53,0.358,42,78,0.538,0.538,20,23,0.87,19,34,53,6,8,15,12,34,161
Bruce Brown,4736102,AL,25,BRK,72,45,1774,256,506,0.506,38,94,0.404,218,412,0.529,0.543,97,128,0.758,100,245,345,148,77,52,56,176,647
Bruno Fernando,1782621,P,23,HOU,30,0,152,36,55,0.655,1,2,0.5,35,53,0.66,0.664,15,24,0.625,18,37,55,7,1,11,14,24,88
Bryn Forbes,4500000,ES,28,DEN,75,2,1286,231,539,0.429,122,295,0.414,109,244,0.447,0.542,79,87,0.908,10,83,93,75,25,5,56,95,663
Buddy Hield,23085960,ES,29,IND,81,32,2499,446,1098,0.406,262,716,0.366,184,382,0.482,0.526,111,127,0.874,66,287,353,229,73,25,153,184,1265
CJ Elleby,1517981,AL,21,POR,58,28,1174,121,308,0.393,37,126,0.294,84,182,0.462,0.453,60,84,0.714,66,161,227,87,35,19,56,116,339
CJ McCollum,30864198,ES,30,NOP,62,62,2145,536,1164,0.46,182,469,0.388,354,695,0.509,0.539,116,170,0.682,53,216,269,315,70,22,127,121,1370
Cade Cunningham,10050120,BA,20,DET,64,64,2088,429,1031,0.416,114,363,0.314,315,668,0.472,0.471,142,168,0.845,58,296,354,356,78,43,234,200,1114
Caleb Martin,84668,AL,26,MIA,60,12,1372,208,410,0.507,64,155,0.413,144,255,0.565,0.585,71,93,0.763,70,160,230,64,58,30,52,104,551
Cam Reddish,4670160,AL,22,NYK,49,7,1012,165,408,0.404,66,184,0.359,99,224,0.442,0.485,101,112,0.902,25,80,105,48,47,15,57,60,497
Cam Thomas,2036280,ES,20,BRK,67,2,1176,218,503,0.433,47,174,0.27,171,329,0.52,0.48,87,105,0.829,16,145,161,78,33,8,55,66,570
Cameron Johnson,4437000,AP,25,PHO,66,16,1730,279,607,0.46,166,391,0.425,113,216,0.523,0.596,98,114,0.86,42,231,273,99,57,16,47,113,822
Cameron McGriff,53176,AL,24,POR,3,0,46,5,14,0.357,2,6,0.333,3,8,0.375,0.429,2,2,1.0,6,9,15,3,0,1,0,7,14
Cameron Oliver,85578,AL,25,ATL,2,0,43,10,15,0.667,1,3,0.333,9,12,0.75,0.7,2,3,0.667,2,4,6,3,1,1,0,5,23
Cameron Payne,6500000,BA,27,PHO,58,12,1278,240,587,0.409,71,211,0.336,169,376,0.449,0.469,75,89,0.843,24,151,175,282,40,17,103,119,626
Caris LeVert,17500000,ES,27,CLE,58,49,1781,379,854,0.444,82,256,0.32,297,598,0.497,0.492,146,193,0.756,43,171,214,248,51,23,108,131,986
Carlik Jones,53176,BA,24,DEN,5,0,23,1,9,0.111,0,1,0.0,1,8,0.125,0.111,2,2,1.0,1,2,3,5,1,0,3,0,4
Carmelo Anthony,2641691,AP,37,LAL,69,3,1793,319,723,0.441,149,397,0.375,170,326,0.521,0.544,132,159,0.83,62,226,288,68,47,52,59,166,919
Carsen Edwards,1800004,ES,23,DET,4,0,79,9,30,0.3,4,16,0.25,5,14,0.357,0.367,1,1,1.0,2,4,6,14,2,0,5,4,23
Cassius Stanley,256734,ES,22,DET,9,1,155,19,46,0.413,4,17,0.235,15,29,0.517,0.457,10,10,1.0,5,14,19,4,5,2,6,17,52
Cedi Osman,8133334,AL,26,CLE,66,3,1462,247,572,0.432,128,359,0.357,119,213,0.559,0.544,87,131,0.664,25,121,146,135,52,10,67,127,709
Charles Bassey,925258,AP,21,PHI,23,0,168,30,47,0.638,0,4,0.0,30,43,0.698,0.638,9,12,0.75,22,40,62,7,5,17,8,32,69
Chimezie Met,1762796,P,24,SAC,60,20,1279,203,449,0.452,57,186,0.306,146,263,0.555,0.516,71,91,0.78,34,301,335,60,51,32,61,93,534
Chris Boucher,7020000,AP,29,TOR,80,9,1690,268,577,0.464,68,229,0.297,200,348,0.575,0.523,150,193,0.777,179,315,494,25,49,75,42,174,754
Chris Duarte,3749520,ES,24,IND,55,39,1541,268,621,0.432,94,255,0.369,174,366,0.475,0.507,90,112,0.804,41,185,226,114,56,10,90,95,720
Chris Paul,30800000,BA,36,PHO,65,65,2139,363,736,0.493,63,199,0.317,300,537,0.559,0.536,169,202,0.837,22,261,283,702,121,20,153,134,958
Christian Wood,13666667,P,26,HOU,68,67,2094,440,878,0.501,131,336,0.39,309,542,0.57,0.576,207,332,0.623,110,576,686,155,54,65,126,171,1218
Chuma Okeke,3277080,AP,23,ORL,70,20,1749,216,575,0.376,118,371,0.318,98,204,0.48,0.478,55,65,0.846,47,300,347,118,97,42,57,95,605
Clint Capela,18603448,P,27,ATL,74,73,2042,370,604,0.613,0,1,0.0,370,603,0.614,0.613,80,169,0.473,279,598,877,92,55,93,44,166,820
Coby White,5837760,BA,21,CHI,61,17,1675,279,644,0.433,136,353,0.385,143,291,0.491,0.539,78,91,0.857,17,165,182,176,29,11,70,137,772
Cody Martin,1782621,AL,26,CHO,71,11,1866,204,423,0.482,61,159,0.384,143,264,0.542,0.554,75,107,0.701,82,203,285,179,88,32,61,116,544
Cody Zeller,2389641,P,29,POR,27,0,355,51,90,0.567,0,4,0.0,51,86,0.593,0.567,38,49,0.776,50,75,125,22,8,6,19,56,140
Cole Anthony,3449400,BA,21,ORL,65,65,2059,357,912,0.391,132,391,0.338,225,521,0.432,0.464,216,253,0.854,32,316,348,369,46,17,170,171,1062
Collin Sexton,6349671,ES,23,CLE,11,11,316,68,151,0.45,11,45,0.244,57,106,0.538,0.487,29,39,0.744,13,23,36,23,10,0,31,25,176
Corey Kispert,3383640,AL,22,WAS,77,36,1801,234,514,0.455,112,320,0.35,122,194,0.629,0.564,54,62,0.871,53,156,209,85,35,22,50,93,634
Cory Joseph,7310000,BA,30,DET,65,39,1600,178,400,0.445,65,157,0.414,113,243,0.465,0.526,100,113,0.885,29,145,174,237,42,17,85,147,521
D.J. Augustin,7000000,BA,34,LAL,55,2,883,94,222,0.423,68,164,0.415,26,58,0.448,0.577,38,43,0.884,11,57,68,107,17,1,56,39,294
D.J. Wilson,308493,AP,25,TOR,4,1,54,11,15,0.733,0,2,0.0,11,13,0.846,0.733,8,10,0.8,1,15,16,5,5,1,2,6,30
Daishen Nix,611521,ES,19,HOU,24,0,261,27,67,0.403,7,26,0.269,20,41,0.488,0.455,16,30,0.533,7,26,33,40,15,0,26,21,77
Dalano Banton,925258,BA,22,TOR,64,1,696,83,202,0.411,13,51,0.255,70,151,0.464,0.443,26,44,0.591,38,86,124,99,28,10,53,68,205
Damian Jones,1977011,P,26,SAC,56,15,1017,175,266,0.658,10,29,0.345,165,237,0.696,0.677,94,131,0.718,75,171,246,69,26,47,59,130,454
Damian Lillard,39344900,BA,31,POR,29,29,1056,222,552,0.402,92,284,0.324,130,268,0.485,0.486,159,181,0.878,13,107,120,212,17,11,83,37,695
Damion L,1910860,ES,29,GSW,63,5,1256,169,383,0.441,63,187,0.337,106,196,0.541,0.523,66,75,0.88,27,176,203,63,39,6,38,95,467
D'Angelo Russell,30013500,BA,25,MIN,65,65,2077,401,975,0.411,176,518,0.34,225,457,0.492,0.502,198,240,0.825,25,191,216,460,62,22,165,130,1176
Daniel Gafford,1782621,P,23,WAS,72,53,1444,285,411,0.693,0,1,0.0,285,410,0.695,0.693,107,153,0.699,155,252,407,68,30,99,65,170,677
Daniel Oturu,1585578,P,22,TOR,3,0,27,3,6,0.5,0,1,0.0,3,5,0.6,0.5,3,5,0.6,1,4,5,0,0,2,0,1,9
Daniel Theis,8280351,P,29,BOS,47,27,977,151,291,0.519,33,107,0.308,118,184,0.641,0.576,49,72,0.681,59,169,228,41,20,31,46,111,384
Danilo Gallinari,20475000,AP,33,ATL,66,18,1672,259,597,0.434,112,294,0.381,147,303,0.485,0.528,141,156,0.904,35,273,308,101,28,12,38,93,771
Danny Green,10000000,AL,34,PHI,62,28,1353,126,320,0.394,103,271,0.38,23,49,0.469,0.555,11,14,0.786,32,125,157,64,60,37,45,105,366
Danuel House Jr.,4100000,AL,28,UTA,42,7,727,80,198,0.404,44,117,0.376,36,81,0.444,0.515,44,58,0.759,18,93,111,44,21,17,33,51,248
Darius Bazley,2513040,AP,21,OKC,69,53,1924,274,649,0.422,80,269,0.297,194,380,0.511,0.484,117,170,0.688,71,365,436,97,58,70,90,68,745
Darius Garland,7040880,BA,22,CLE,68,68,2430,542,1173,0.462,174,454,0.383,368,719,0.512,0.536,215,241,0.892,39,185,224,583,89,7,248,115,1473
David Nwaba,4650000,AL,29,HOU,46,4,609,85,176,0.483,15,49,0.306,70,127,0.551,0.526,48,67,0.716,41,110,151,35,28,20,21,55,233
Davion Mitchell,4603320,BA,23,SAC,75,19,2076,352,843,0.418,101,320,0.316,251,523,0.48,0.477,56,85,0.659,33,133,166,313,55,24,114,141,861
Dāvis Bertāns,16000000,AP,29,DAL,56,0,807,99,275,0.36,77,230,0.335,22,45,0.489,0.5,36,40,0.9,12,105,117,31,17,12,19,85,311
Davon Ree,532398,ES,26,DEN,48,5,668,81,161,0.503,37,86,0.43,44,75,0.587,0.618,10,15,0.667,14,94,108,53,24,9,16,63,209
Day'Ron Sharpe,2009040,AP,20,BRK,32,8,391,86,149,0.577,2,7,0.286,84,142,0.592,0.584,24,41,0.585,81,79,160,17,10,15,30,60,198
De'Aaron F,28103500,BA,24,SAC,59,59,2083,516,1092,0.473,74,249,0.297,442,843,0.524,0.506,261,348,0.75,25,206,231,330,68,25,168,172,1367
Dean Wad,1782621,AP,25,CLE,51,28,980,99,217,0.456,51,142,0.359,48,75,0.64,0.574,20,30,0.667,31,119,150,52,29,7,16,88,269
Deandre Ayton,12632950,P,23,PHO,58,58,1713,442,697,0.634,7,19,0.368,435,678,0.642,0.639,106,142,0.746,149,444,593,84,40,40,91,142,997
DeAndre' Bembry,2500350,AL,27,MIL,56,20,1026,124,221,0.561,15,36,0.417,109,185,0.589,0.595,21,35,0.6,42,121,163,66,49,25,31,113,284
De'Andre Hunter,7775400,AL,24,ATL,53,52,1577,254,575,0.442,74,195,0.379,180,380,0.474,0.506,127,166,0.765,26,150,176,68,36,21,69,155,709
De'Anthony Melton,8805976,ES,23,MEM,73,15,1657,281,695,0.404,139,372,0.374,142,323,0.44,0.504,90,120,0.75,64,264,328,194,104,39,112,128,791
Dejounte Murray,15248880,BA,25,SAS,68,68,2366,573,1241,0.462,96,294,0.327,477,947,0.504,0.5,196,247,0.794,80,483,563,627,138,23,180,138,1438
Delon Wright,8526316,ES,29,ATL,77,8,1452,122,269,0.454,44,116,0.379,78,153,0.51,0.535,54,63,0.857,50,170,220,188,93,19,45,56,342
DeMar DeRozan,26000000,AP,32,CHI,76,76,2743,774,1535,0.504,50,142,0.352,724,1393,0.52,0.521,520,593,0.877,56,336,392,374,68,24,181,178,2118
DeMarcus Cousins,1138659,P,31,DEN,48,7,718,149,324,0.46,37,122,0.303,112,202,0.554,0.517,95,125,0.76,74,196,270,71,35,21,85,139,430
Deni Avdija,4692840,AL,21,WAS,82,8,1984,250,579,0.432,82,259,0.317,168,320,0.525,0.503,103,136,0.757,52,373,425,167,59,44,87,190,685
Dennis Schröder,5890000,ES,28,HOU,64,29,1837,312,724,0.431,86,250,0.344,226,474,0.477,0.49,157,184,0.853,34,180,214,296,53,8,143,154,867
Dennis Smith Jr.,1789256,BA,24,POR,37,4,638,79,189,0.418,6,27,0.222,73,162,0.451,0.434,42,64,0.656,20,68,88,132,45,12,51,52,206
Derrick Favors,9720900,P,30,OKC,39,18,653,94,182,0.516,2,16,0.125,92,166,0.554,0.522,16,25,0.64,58,126,184,25,17,12,9,62,206
Derrick Jones Jr.,9720900,AP,24,CHI,51,8,899,105,195,0.538,20,61,0.328,85,134,0.634,0.59,56,70,0.8,60,109,169,30,25,33,30,105,286
Derrick Ros,13445120,BA,33,NYK,26,4,636,122,274,0.445,37,92,0.402,85,182,0.467,0.513,30,31,0.968,21,57,78,103,22,12,39,15,311
Derrick Walton,95930,BA,26,DET,3,3,108,6,26,0.231,3,13,0.231,3,13,0.231,0.288,4,4,1.0,2,8,10,21,7,4,11,8,19
Derrick White,15178571,ES,27,BOS,75,52,2199,337,800,0.421,115,369,0.312,222,431,0.515,0.493,203,235,0.864,38,223,261,366,64,58,119,172,992
Desmond Bane,2033160,AL,23,MEM,76,76,2266,508,1101,0.461,228,523,0.436,280,578,0.484,0.565,140,155,0.903,46,288,334,208,92,29,111,196,1384
Devin Booker,31650600,ES,25,PHO,68,68,2345,662,1421,0.466,183,478,0.383,479,943,0.508,0.53,315,363,0.868,45,297,342,329,77,26,162,180,1822
Devin Cannady,94136,BA,25,ORL,5,0,145,15,44,0.341,15,37,0.405,0,7,0.0,0.511,5,7,0.714,1,5,6,10,5,3,5,9,50
Devin Vassell,4235160,AL,21,SAS,71,32,1937,326,764,0.427,137,380,0.361,189,384,0.492,0.516,83,99,0.838,44,262,306,136,76,41,58,143,872
Devon Dotson,239291,BA,22,CHI,11,0,85,11,23,0.478,2,9,0.222,9,14,0.643,0.522,5,9,0.556,1,8,9,15,1,0,5,11,29
Devonte' Graham,11000000,BA,26,NOP,76,63,2162,296,815,0.363,192,563,0.341,104,252,0.413,0.481,118,140,0.843,37,140,177,316,71,12,105,95,902
Dewayne Dedmon,2389641,P,32,MIA,67,15,1065,164,290,0.566,19,47,0.404,145,243,0.597,0.598,75,100,0.75,105,281,386,47,24,42,70,174,422
Didi Louzada,1768878,AL,22,POR,9,1,129,12,33,0.364,9,23,0.391,3,10,0.3,0.5,2,2,1.0,5,12,17,5,2,2,5,13,35
Dillon Brooks,12200000,AL,26,MEM,32,31,885,227,526,0.432,46,149,0.309,181,377,0.48,0.475,90,106,0.849,29,73,102,88,36,8,50,105,590
Domantas Sabonis,19800000,AP,25,SAC,62,61,2136,443,773,0.573,39,125,0.312,404,648,0.623,0.598,246,332,0.741,201,551,752,323,59,27,195,203,1171
Donovan Mitchell,28103500,ES,25,UTA,67,67,2266,617,1376,0.448,232,654,0.355,385,722,0.533,0.533,267,313,0.853,55,227,282,358,99,12,200,164,1733
Donte DiVincenzo,4675830,ES,25,SAC,42,1,1006,118,336,0.351,74,218,0.339,44,118,0.373,0.461,70,83,0.843,40,130,170,118,48,8,72,69,380
Dorian Finney-Smith,4000000,AP,28,DAL,80,80,2644,326,692,0.471,172,435,0.395,154,257,0.599,0.595,56,83,0.675,122,253,375,150,88,39,80,183,880
Doug McDermott,13750000,AP,30,SAS,51,51,1223,215,465,0.462,108,256,0.422,107,209,0.512,0.578,40,51,0.784,18,97,115,64,13,6,43,79,578
Draymond Green,24026712,AP,31,GSW,46,44,1329,135,257,0.525,16,54,0.296,119,203,0.586,0.556,60,91,0.659,45,291,336,320,61,50,139,136,346
Drew Eubanks,1796900,P,24,POR,71,31,1245,221,371,0.596,5,23,0.217,216,348,0.621,0.602,99,130,0.762,130,252,382,85,31,40,81,122,546
Duane Washington Jr.,462629,BA,21,IND,48,7,968,173,427,0.405,81,215,0.377,92,212,0.434,0.5,46,61,0.754,4,79,83,85,26,3,57,66,473
Duncan Robinson,15650000,ES,27,MIA,79,68,2043,290,726,0.399,232,624,0.372,58,102,0.569,0.559,51,61,0.836,24,179,203,129,42,14,60,201,863
Dwight Howard,2641691,P,36,LAL,60,27,971,134,219,0.612,8,15,0.533,126,204,0.618,0.63,96,146,0.658,118,238,356,35,34,36,47,115,372
Dwight Powell,11080125,P,30,DAL,82,71,1798,269,401,0.671,13,37,0.351,256,364,0.703,0.687,166,212,0.783,173,231,404,97,37,39,64,220,717
Dylan Windler,2239200,AL,25,CLE,50,0,459,37,98,0.378,21,70,0.3,16,28,0.571,0.485,15,18,0.833,21,68,89,34,14,3,16,47,110
Elfrid Payton,2239544,BA,27,PHO,50,1,549,67,175,0.383,4,18,0.222,63,157,0.401,0.394,12,32,0.375,21,67,88,99,25,6,47,38,150
Elijah Hughes,1517981,AL,23,POR,36,4,434,47,144,0.326,25,95,0.263,22,49,0.449,0.413,7,9,0.778,6,52,58,22,14,8,17,39,126
Enes Freedom,2641691,P,29,BOS,35,1,411,51,97,0.526,2,5,0.4,49,92,0.533,0.536,24,28,0.857,61,99,160,8,5,14,20,42,128
Eric Bledsoe,18125000,BA,32,LAC,54,29,1361,197,468,0.421,51,163,0.313,146,305,0.479,0.475,89,117,0.761,28,154,182,225,69,19,116,85,534
Eric Gordon,18218818,ES,33,HOU,57,46,1669,268,564,0.475,124,301,0.412,144,263,0.548,0.585,105,135,0.778,15,98,113,154,28,18,107,63,765
Eric Paschall,1782621,AP,25,UTA,58,3,736,114,235,0.485,40,108,0.37,74,127,0.583,0.57,66,86,0.767,30,76,106,36,9,5,27,51,334
Eugene Omoruyi,188774,AL,24,DAL,4,0,18,2,5,0.4,1,2,0.5,1,3,0.333,0.5,2,4,0.5,2,5,7,2,0,0,0,2,7
Evan Fournier,17142857,ES,29,NYK,80,80,2358,402,965,0.417,241,619,0.389,161,346,0.465,0.541,80,113,0.708,34,176,210,171,79,20,105,180,1125
Evan Mobley,8075160,AP,20,CLE,69,69,2331,422,830,0.508,23,92,0.25,399,738,0.541,0.522,167,252,0.663,143,427,570,174,56,115,133,147,1034
Facundo Campazzo,3200000,BA,30,DEN,65,4,1184,107,296,0.361,58,193,0.301,49,103,0.476,0.459,60,78,0.769,23,94,117,220,63,23,67,124,332
Frank Jackson,3000000,BA,23,DET,53,7,1164,194,483,0.402,86,279,0.308,108,204,0.529,0.491,86,104,0.827,19,68,87,55,27,9,38,89,560
Frank Kaminsky,2089448,P,28,PHO,9,0,181,36,66,0.545,5,15,0.333,31,51,0.608,0.583,18,20,0.9,11,30,41,13,8,7,5,14,95
Frank Ntilikina,1789256,BA,23,DAL,58,5,685,89,223,0.399,38,111,0.342,51,112,0.455,0.484,24,25,0.96,12,67,79,69,27,7,31,61,240
Franz Wagner,5007840,AL,20,ORL,79,79,2429,456,975,0.468,96,271,0.354,360,704,0.511,0.517,189,219,0.863,84,272,356,231,68,34,119,164,1197
Fred VanVleet,19675926,BA,27,TOR,65,65,2462,442,1097,0.403,242,642,0.377,200,455,0.44,0.513,194,222,0.874,44,245,289,434,111,35,170,162,1320
Freddie Gillespie,250000,AP,24,ORL,9,2,119,9,22,0.409,0,1,0.0,9,21,0.429,0.409,3,7,0.429,13,23,36,5,3,9,5,18,21
Furkan Korkmaz,4629630,ES,24,PHI,67,19,1414,182,470,0.387,77,266,0.289,105,204,0.515,0.469,68,84,0.81,22,153,175,127,33,9,48,58,509
Gabe Vincent,1669178,BA,25,MIA,68,27,1589,214,513,0.417,119,323,0.368,95,190,0.5,0.533,44,54,0.815,22,104,126,210,62,12,98,158,591
Garrett Temple,4910000,ES,35,NOP,59,16,1098,111,295,0.376,59,185,0.319,52,110,0.473,0.476,28,41,0.683,29,114,143,74,43,23,42,81,309
Garrison Mathews,1255785,ES,25,HOU,65,33,1712,184,461,0.399,139,386,0.36,45,75,0.6,0.55,143,180,0.794,32,158,190,64,57,24,41,168,650
Gary Clark,622253,AP,27,NOP,38,1,378,33,88,0.375,28,70,0.4,5,18,0.278,0.534,7,10,0.7,23,67,90,18,13,7,10,20,101
Gary Harris,20482143,ES,27,ORL,61,30,1730,240,553,0.434,116,302,0.384,124,251,0.494,0.539,83,95,0.874,36,86,122,108,59,9,61,112,679
Gary Payton II,2598354,BA,29,GSW,71,16,1247,212,344,0.616,43,120,0.358,169,224,0.754,0.679,35,58,0.603,72,175,247,64,96,22,40,131,502
Gary Trent Jr.,16000000,ES,23,TOR,70,69,2448,450,1086,0.414,209,545,0.383,241,541,0.445,0.511,174,204,0.853,26,165,191,141,122,19,73,144,1283
George Hil,4000000,ES,35,MIL,54,17,1253,118,275,0.429,41,134,0.306,77,141,0.546,0.504,57,62,0.919,38,117,155,120,42,6,41,70,334
George Kin,85578,AL,28,DAL,4,0,19,0,5,0.0,0,4,0.0,0,1,0.0,0.0,1,2,0.5,0,5,5,0,0,0,1,4,1
Georges Niang,3300000,AP,28,PHI,76,7,1736,246,563,0.437,156,387,0.403,90,176,0.511,0.575,52,59,0.881,25,178,203,102,30,13,59,190,700
Georgios Kalaitzakis,553176,AL,23,OKC,13,4,214,31,67,0.463,10,26,0.385,21,41,0.512,0.537,14,30,0.467,6,15,21,12,11,2,20,19,86
Giannis Antetokounmpo,39344900,AP,27,MIL,67,67,2204,689,1245,0.553,71,242,0.293,618,1003,0.616,0.582,553,766,0.722,134,644,778,388,72,91,219,212,2002
Goga Bitadze,3098400,P,22,IND,50,16,729,131,252,0.52,23,80,0.288,108,172,0.628,0.565,64,94,0.681,79,98,177,55,21,42,46,107,349
Goran Dragić,18000000,BA,35,BRK,21,8,498,57,151,0.377,16,63,0.254,41,88,0.466,0.43,27,33,0.818,13,52,65,86,19,4,34,45,157
Gordon Hayward,29925000,AL,31,CHO,49,48,1564,283,617,0.459,86,220,0.391,197,397,0.496,0.528,126,149,0.846,38,186,224,177,47,22,81,85,778
Gorgui Dieng,4000000,P,32,ATL,44,3,371,53,112,0.473,29,68,0.426,24,44,0.545,0.603,19,26,0.731,32,89,121,34,11,13,20,52,154
Grant Williams,2617800,AP,23,BOS,77,21,1875,205,432,0.475,106,258,0.411,99,174,0.569,0.597,86,95,0.905,64,210,274,78,38,57,62,186,602
Grayson Allen,4054695,ES,26,MIL,66,61,1805,255,569,0.448,159,389,0.409,96,180,0.533,0.588,64,74,0.865,32,190,222,100,46,18,43,96,733
Greg Brown III,925258,AL,20,POR,48,6,640,81,190,0.426,19,61,0.311,62,129,0.481,0.476,44,65,0.677,38,97,135,35,26,24,36,90,225
Hamidou Diallo,5200000,ES,23,DET,58,29,1269,261,526,0.496,23,93,0.247,238,433,0.55,0.518,91,140,0.65,69,208,277,73,71,17,58,143,636
Harrison Barnes,20284091,AP,29,SAC,77,77,2587,391,834,0.469,142,360,0.394,249,474,0.525,0.554,341,413,0.826,82,350,432,186,53,14,118,94,1265
Hassani Gravett,106352,BA,25,ORL,8,3,171,18,38,0.474,11,26,0.423,7,12,0.583,0.618,3,4,0.75,1,20,21,20,5,1,9,13,50
Haywood Highsmith,547341,AL,25,MIA,19,1,163,16,46,0.348,9,28,0.321,7,18,0.389,0.446,2,5,0.4,10,16,26,6,2,3,3,13,43
Herbert Jones,1700000,AP,23,NOP,78,69,2335,274,576,0.476,57,169,0.337,217,407,0.533,0.525,137,163,0.84,98,198,296,167,130,60,100,238,742
Immanuel Quickley,2210640,BA,22,NYK,78,3,1802,284,724,0.392,137,396,0.346,147,328,0.448,0.487,177,201,0.881,31,216,247,275,54,3,99,167,882
Isaac Bonga,1729217,AL,22,TOR,15,0,69,3,13,0.231,1,4,0.25,2,9,0.222,0.269,5,8,0.625,4,3,7,4,8,2,2,10,12
Isaac Okoro,6720720,AL,21,CLE,67,61,1981,207,431,0.48,55,157,0.35,152,274,0.555,0.544,119,155,0.768,72,129,201,121,56,22,58,164,588
Isaiah Hartenstein,1729217,P,23,LAC,68,0,1216,229,366,0.626,14,30,0.467,215,336,0.64,0.645,91,132,0.689,117,215,332,160,50,77,84,167,563
Isaiah J,2451120,ES,22,PHI,55,1,609,62,177,0.35,45,135,0.333,17,42,0.405,0.477,29,31,0.935,6,50,56,35,14,3,19,47,198
Isaiah Jackson,1517981,AP,20,IND,36,15,541,116,206,0.563,5,16,0.313,111,190,0.584,0.575,60,88,0.682,60,89,149,10,25,52,40,92,297
Isaiah Livers,1057260,AL,23,DET,19,5,383,41,90,0.456,27,64,0.422,14,26,0.538,0.606,12,14,0.857,15,42,57,21,13,7,15,37,121
Isaiah Rob,1782621,AP,23,OKC,45,28,948,166,323,0.514,44,99,0.444,122,224,0.545,0.582,78,116,0.672,75,142,217,71,36,34,43,109,454
Isaiah Stewart,3277080,P,20,DET,71,71,1816,250,490,0.51,15,46,0.326,235,444,0.529,0.526,74,103,0.718,226,391,617,82,22,78,85,211,589
Isaiah Thomas,607285,BA,32,CHO,22,1,333,67,167,0.401,28,83,0.337,39,84,0.464,0.485,22,26,0.846,4,25,29,34,7,5,15,34,184
Isaiah Tod,1500000,AP,20,WAS,12,0,74,7,26,0.269,4,16,0.25,3,10,0.3,0.346,2,6,0.333,3,9,12,4,4,2,4,4,20
Ish Smith,4500000,BA,33,WAS,65,1,1126,185,430,0.43,25,67,0.373,160,363,0.441,0.459,15,24,0.625,25,115,140,244,47,23,78,78,410
Ish Wainright,467947,AP,27,PHO,45,0,359,41,104,0.394,19,59,0.322,22,45,0.489,0.486,7,12,0.583,27,27,54,15,20,6,13,49,108
Ja Morant,9603360,BA,22,MEM,57,57,1889,580,1177,0.493,88,256,0.344,492,921,0.534,0.53,316,415,0.761,77,248,325,384,66,22,196,86,1564
Jabari Parker,1068288,AP,26,BOS,12,0,112,18,38,0.474,8,16,0.5,10,22,0.455,0.579,9,9,1.0,5,23,28,6,4,1,8,13,53
Jaden McDaniels,2063280,AP,21,MIN,70,31,1803,255,554,0.46,80,252,0.317,175,302,0.579,0.532,57,71,0.803,76,217,293,79,52,54,75,224,647
Jae Crowder,9720900,AP,31,PHO,67,67,1886,217,544,0.399,127,365,0.348,90,179,0.503,0.516,71,90,0.789,30,324,354,124,95,30,55,173,632
Jae'Sean Tat,1517981,AL,26,HOU,78,77,2056,363,729,0.498,63,202,0.312,300,527,0.569,0.541,130,184,0.707,135,285,420,222,72,41,139,286,919
Jahmi'us Ramsey,1517981,ES,20,SAC,19,0,134,24,58,0.414,5,18,0.278,19,40,0.475,0.457,7,14,0.5,4,9,13,7,1,1,5,10,60
Jake Layman,3940184,AL,27,MIN,34,1,231,30,73,0.411,8,35,0.229,22,38,0.579,0.466,13,18,0.722,6,30,36,9,7,5,10,12,81
Jakob Poeltl,8750000,P,26,SAS,68,67,1970,410,663,0.618,1,1,1.0,409,662,0.618,0.619,94,190,0.495,262,372,634,189,45,118,109,212,915
Jalen Brunson,1802057,BA,25,DAL,79,61,2524,506,1008,0.502,94,252,0.373,412,756,0.545,0.549,179,213,0.84,43,266,309,377,66,3,124,151,1285
Jalen Green,8992200,ES,19,HOU,67,67,2138,406,954,0.426,157,458,0.343,249,496,0.502,0.508,188,236,0.797,33,193,226,176,44,18,135,103,1157
Jalen Johnson,2659560,AP,20,ATL,22,0,120,22,41,0.537,3,13,0.231,19,28,0.679,0.573,5,7,0.714,2,24,26,3,3,2,9,9,52
Jalen McDaniels,1782621,AL,24,CHO,55,2,895,123,254,0.484,41,108,0.38,82,146,0.562,0.565,53,72,0.736,37,133,170,58,26,22,36,93,340
Jalen Smith,4458000,AP,21,IND,51,8,925,176,350,0.503,40,122,0.328,136,228,0.596,0.56,78,102,0.765,101,206,307,24,15,41,42,96,470
Jalen Suggs,6593040,BA,20,ORL,48,45,1307,198,548,0.361,42,196,0.214,156,352,0.443,0.4,126,163,0.773,26,145,171,209,59,19,143,142,564
James Bouknight,4154400,ES,21,CHO,31,0,304,49,141,0.348,17,49,0.347,32,92,0.348,0.408,27,31,0.871,22,30,52,26,7,1,15,29,142
James Ennis III,128709,AL,31,DEN,7,0,56,11,24,0.458,3,8,0.375,8,16,0.5,0.521,4,5,0.8,5,7,12,3,2,2,2,5,29
James Harden,44310840,BA,32,PHI,65,65,2419,407,992,0.41,148,448,0.33,259,544,0.476,0.485,470,536,0.877,55,445,500,667,82,36,284,153,1432
James Johnson,2641691,AP,34,BRK,62,10,1191,144,307,0.469,23,85,0.271,121,222,0.545,0.507,29,55,0.527,51,164,215,130,30,34,48,162,340
JaMychal Green,8292683,AP,31,DEN,67,8,1085,159,327,0.486,33,124,0.266,126,203,0.621,0.537,81,93,0.871,81,200,281,59,43,26,57,158,432
Jared Butler,925258,ES,21,UTA,42,1,360,61,151,0.404,28,88,0.318,33,63,0.524,0.497,11,16,0.688,5,40,45,63,17,8,33,47,161
Jaren Jackson Jr.,9180560,AP,22,MEM,78,78,2126,430,1036,0.415,128,401,0.319,302,635,0.476,0.477,284,345,0.823,119,335,454,86,73,177,130,272,1272
Jarred Vanderbilt,4050000,AP,22,MIN,74,67,1880,212,361,0.587,2,14,0.143,210,347,0.605,0.59,86,131,0.656,215,409,624,94,99,46,73,181,512
Jarrett Allen,20000000,P,23,CLE,56,56,1809,369,545,0.677,1,10,0.1,368,535,0.688,0.678,165,233,0.708,192,410,602,92,44,75,94,97,904
Jarrett Culver,6395160,ES,22,MEM,37,0,338,51,135,0.378,12,47,0.255,39,88,0.443,0.422,16,34,0.471,13,35,48,33,20,5,20,42,130
JaVale McGee,5000000,P,34,PHO,74,17,1172,288,458,0.629,2,9,0.222,286,449,0.637,0.631,102,146,0.699,163,333,496,42,22,81,98,181,680
Javonte Green,1669178,AL,28,CHI,65,45,1519,176,325,0.542,36,101,0.356,140,224,0.625,0.597,80,96,0.833,91,185,276,60,67,32,30,132,468
Jaxson Hayes,5348280,P,21,NOP,70,28,1398,245,398,0.616,20,57,0.351,225,341,0.66,0.641,144,188,0.766,115,200,315,43,33,55,54,155,654
Jaylen Brown,26758928,AL,25,BOS,66,66,2220,576,1217,0.473,166,464,0.358,410,753,0.544,0.541,241,318,0.758,53,351,404,231,70,18,178,163,1559
Jaylen Hoard,191860,AL,22,OKC,7,5,240,44,90,0.489,9,25,0.36,35,65,0.538,0.539,6,14,0.429,30,54,84,17,6,5,8,14,103
Jaylen Morris,95930,ES,26,SAS,3,0,16,0,6,0.0,0,2,0.0,0,4,0.0,0.0,2,4,0.5,0,2,2,2,0,0,1,2,2
Jaylen Nowell,1782621,ES,22,MIN,62,1,975,196,413,0.475,63,160,0.394,133,253,0.526,0.551,72,92,0.783,22,101,123,130,27,10,36,73,527
Jayson Tatum,28103500,AL,23,BOS,76,76,2731,708,1564,0.453,230,651,0.353,478,913,0.524,0.526,400,469,0.853,85,524,609,334,75,49,217,174,2046
Jeff Dowtin,253176,BA,24,ORL,9,0,108,8,26,0.308,1,9,0.111,7,17,0.412,0.327,2,2,1.0,8,10,18,10,5,1,5,5,19
Jeff Green,4500000,P,35,DEN,75,63,1849,277,529,0.524,53,168,0.315,224,361,0.62,0.574,165,198,0.833,41,190,231,96,28,27,71,151,772
Jerami Grant,20002500,AP,27,DET,47,47,1500,298,699,0.426,91,254,0.358,207,445,0.465,0.491,217,259,0.838,28,163,191,111,44,49,85,107,904
Jeremiah Robinson-Earl,2000000,P,21,OKC,49,36,1087,134,324,0.414,58,165,0.352,76,159,0.478,0.503,40,54,0.741,75,199,274,49,29,15,39,75,366
Jeremy Lamb,10500000,ES,29,SAC,56,0,935,133,347,0.383,55,170,0.324,78,177,0.441,0.463,89,106,0.84,26,128,154,81,31,22,37,59,410
Jevon Carter,457149,BA,26,MIL,66,3,905,98,253,0.387,66,170,0.388,32,83,0.386,0.518,15,18,0.833,14,96,110,96,24,14,34,67,277
Jimmy Butler,36016200,AL,32,MIA,57,57,1931,398,829,0.48,27,116,0.233,371,713,0.52,0.496,396,455,0.87,102,234,336,312,94,27,121,88,1219
Jock Landale,925258,P,26,SAS,54,1,589,101,204,0.495,29,89,0.326,72,115,0.626,0.566,34,41,0.829,63,75,138,45,10,14,31,53,265
Joe Harris,17357143,AL,30,BRK,14,14,423,56,124,0.452,41,88,0.466,15,36,0.417,0.617,5,6,0.833,5,51,56,14,7,2,16,31,158
Joe Ingles,13036364,AL,34,UTA,45,15,1122,115,285,0.404,78,225,0.347,37,60,0.617,0.54,17,22,0.773,12,119,131,158,23,5,46,82,325
Joe Wieskamp,566322,ES,22,SAS,29,0,205,20,56,0.357,14,43,0.326,6,13,0.462,0.482,7,13,0.538,4,10,14,9,4,3,2,14,61
Joel Embiid,31579390,P,27,PHI,68,68,2297,666,1334,0.499,93,251,0.371,573,1083,0.529,0.534,654,803,0.814,146,650,796,284,77,99,214,181,2079
John Collins,23000000,AP,24,ATL,54,53,1663,339,644,0.526,64,176,0.364,275,468,0.588,0.576,134,169,0.793,93,329,422,98,33,56,60,164,876
John Konchar,2200000,ES,25,MEM,72,7,1292,135,262,0.515,52,126,0.413,83,136,0.61,0.615,27,49,0.551,87,242,329,109,45,22,29,90,349
Jonas Valančiūnas,14000000,P,29,NOP,74,74,2240,510,938,0.544,57,158,0.361,453,780,0.581,0.574,237,289,0.82,226,617,843,190,41,60,179,247,1314
Jonathan Kuminga,5466360,AL,19,GSW,70,12,1185,236,460,0.513,50,149,0.336,186,311,0.598,0.567,130,190,0.684,54,180,234,64,31,22,74,146,652
Jordan Clarkson,12420000,ES,29,UTA,79,1,2141,466,1113,0.419,190,597,0.318,276,516,0.535,0.504,144,174,0.828,67,206,273,194,66,16,129,149,1266
Jordan McLaughlin,2000000,BA,25,MIN,62,3,902,88,200,0.44,27,85,0.318,61,115,0.53,0.508,30,40,0.75,22,72,94,180,57,10,38,54,233
Jordan Nwora,1517981,AL,23,MIL,62,13,1185,186,462,0.403,79,227,0.348,107,235,0.455,0.488,36,43,0.837,37,184,221,59,25,17,57,78,487
Jordan Poole,2161440,ES,22,GSW,76,51,2283,474,1058,0.448,211,580,0.364,263,478,0.55,0.548,246,266,0.925,34,226,260,304,60,23,187,206,1405
Jose Alvarado,1500000,BA,23,NOP,54,1,834,131,294,0.446,32,110,0.291,99,184,0.538,0.5,36,53,0.679,25,75,100,152,71,7,40,73,330
Josh Christopher,2259240,ES,20,HOU,74,2,1334,224,500,0.448,56,189,0.296,168,311,0.54,0.504,83,113,0.735,52,134,186,150,65,13,114,97,587
Josh Giddey,5988000,ES,19,OKC,54,54,1700,281,670,0.419,56,213,0.263,225,457,0.492,0.461,56,79,0.709,98,323,421,345,51,20,171,88,674
Josh Green,2957520,ES,21,DAL,67,3,1039,130,256,0.508,28,78,0.359,102,178,0.573,0.563,31,45,0.689,52,109,161,79,45,14,44,115,319
Josh Har,12000000,AL,26,POR,54,53,1791,287,569,0.504,73,213,0.343,214,356,0.601,0.569,160,211,0.758,62,326,388,224,61,13,114,150,807
Josh Jackson,5005350,AL,24,SAC,51,3,830,120,300,0.4,33,130,0.254,87,170,0.512,0.455,55,77,0.714,21,120,141,54,26,22,47,88,328
Josh Okogie,4087904,ES,23,MIN,49,6,516,42,104,0.404,14,47,0.298,28,57,0.491,0.471,35,51,0.686,29,41,70,25,26,12,23,53,133
Joshua Primo,3946800,ES,19,SAS,50,16,965,101,270,0.374,42,137,0.307,59,133,0.444,0.452,44,59,0.746,32,81,113,81,20,23,57,79,288
Josh Richardson,11615328,ES,28,SAS,65,7,1600,234,534,0.438,102,246,0.415,132,288,0.458,0.534,96,108,0.889,42,143,185,115,56,29,66,116,666
Jrue Holiday,32431333,BA,31,MIL,67,64,2207,478,954,0.501,132,321,0.411,346,633,0.547,0.57,137,180,0.761,69,232,301,457,108,29,183,133,1225
Juan Toscano-Anderson,1701593,AL,28,GSW,73,6,994,115,235,0.489,28,87,0.322,87,148,0.588,0.549,40,70,0.571,28,148,176,127,48,17,68,115,298
Juancho Hernangómez,7012440,AP,26,UTA,40,9,445,44,106,0.415,24,69,0.348,20,37,0.541,0.528,19,34,0.559,28,72,100,20,14,10,16,25,131
Julius Randle,21780000,AP,27,NYK,72,72,2544,512,1246,0.411,120,390,0.308,392,856,0.458,0.459,303,401,0.756,125,591,716,370,53,39,245,205,1447
Justin Anderson,111457,AL,28,IND,16,6,316,36,95,0.379,15,59,0.254,21,36,0.583,0.458,15,19,0.789,4,42,46,33,8,6,8,22,102
Justin Holiday,6006420,ES,32,SAC,74,65,2057,261,662,0.394,177,482,0.367,84,180,0.467,0.528,50,62,0.806,29,161,190,128,57,33,70,154,749
Justin Jackson,205662,AL,26,DET,7,0,37,5,15,0.333,3,9,0.333,2,6,0.333,0.433,2,2,1.0,1,6,7,2,0,0,1,3,15
Justin Robinson,119645,BA,24,WOT,25,0,304,28,93,0.301,18,61,0.295,10,32,0.313,0.398,4,8,0.5,4,17,21,32,9,1,17,27,78
Justise Winslow,3902439,AL,25,POR,48,11,774,110,257,0.428,15,66,0.227,95,191,0.497,0.457,39,66,0.591,50,152,202,84,35,25,49,67,274
Jusuf Nurkić,12000000,P,27,POR,56,56,1579,321,600,0.535,15,56,0.268,306,544,0.563,0.548,185,268,0.69,167,452,619,157,62,34,143,189,842
Kentavious Caldwell-Pope,13038862,ES,28,WAS,77,77,2329,361,829,0.435,159,408,0.39,202,421,0.48,0.531,137,154,0.89,41,220,261,145,83,26,97,139,1018
Kenyon Martin Jr.,1517981,AL,21,HOU,79,2,1656,279,523,0.533,60,168,0.357,219,355,0.617,0.591,78,123,0.634,80,217,297,101,34,40,60,113,696
Kai Jones,2770560,P,21,CHO,21,0,63,9,14,0.643,1,2,0.5,8,12,0.667,0.679,3,8,0.375,3,8,11,4,1,2,6,8,22
Karl-Anthony Towns,31650600,P,26,MIN,74,74,2476,642,1214,0.529,150,366,0.41,492,848,0.58,0.591,384,467,0.822,194,533,727,269,72,83,226,267,1818
Keifer Sykes,558345,BA,28,IND,32,11,566,69,190,0.363,27,90,0.3,42,100,0.42,0.434,15,17,0.882,8,37,45,62,12,4,33,51,180
Keita Bates-Diop,1729217,AL,26,SAS,59,14,956,136,263,0.517,17,55,0.309,119,208,0.572,0.549,46,61,0.754,62,169,231,41,27,14,45,61,335
Kelan Martin,191860,AL,26,BOS,30,1,450,70,171,0.409,22,75,0.293,48,96,0.5,0.474,9,13,0.692,17,38,55,21,13,9,14,36,171
Keldon Johnson,2145720,AL,22,SAS,75,74,2392,471,1011,0.466,159,399,0.398,312,612,0.51,0.545,177,234,0.756,80,377,457,158,58,14,92,148,1278
Kelly Olynyk,12195122,P,30,DET,40,1,764,128,286,0.448,40,119,0.336,88,167,0.527,0.517,69,89,0.775,54,123,177,111,31,19,58,100,365
Kelly Oubre Jr.,12000000,AL,26,CHO,76,13,1999,410,932,0.44,191,553,0.345,219,379,0.578,0.542,126,189,0.667,79,223,302,84,77,31,67,189,1137
Kemba Walker,8729020,BA,31,NYK,37,37,948,149,370,0.403,73,199,0.367,76,171,0.444,0.501,60,71,0.845,14,97,111,131,26,7,48,37,431
Kenrich Williams,2000000,AL,27,OKC,49,0,1072,146,317,0.461,41,121,0.339,105,196,0.536,0.525,30,55,0.545,75,145,220,108,44,10,46,81,363
Kent Bazemore,2401537,AL,32,LAL,39,14,545,45,139,0.324,29,80,0.363,16,59,0.271,0.428,13,17,0.765,13,56,69,34,25,9,21,70,132
Keon Johnson,2553120,ES,19,POR,37,12,697,96,272,0.353,34,100,0.34,62,172,0.36,0.415,41,51,0.804,24,57,81,76,28,12,46,69,267
Kessler Edwards,467947,AL,21,BRK,48,23,987,110,267,0.412,48,136,0.353,62,131,0.473,0.502,16,19,0.842,44,128,172,31,29,24,42,85,284
Kevin Durant,42018900,AP,33,BRK,55,55,2047,578,1115,0.518,115,300,0.383,463,815,0.568,0.57,372,409,0.91,29,378,407,351,48,52,191,113,1643
Kevin Huerter,4253357,ES,23,ATL,74,60,2188,345,760,0.454,160,411,0.389,185,349,0.53,0.559,42,52,0.808,32,222,254,203,55,26,91,185,892
Kevin Knox,5845978,AL,22,ATL,30,0,222,31,85,0.365,15,54,0.278,16,31,0.516,0.453,16,22,0.727,14,30,44,10,4,2,7,19,93
Kevin Love,31258256,AP,33,CLE,74,4,1665,327,761,0.43,187,477,0.392,140,284,0.493,0.553,166,198,0.838,87,449,536,160,26,18,98,101,1007
Kevin Pangos,1669178,BA,29,CLE,24,3,166,15,46,0.326,6,26,0.231,9,20,0.45,0.391,3,4,0.75,2,9,11,30,3,0,7,11,39
Kevin Porter Jr.,1782621,BA,21,HOU,61,61,1907,335,808,0.415,155,413,0.375,180,395,0.456,0.511,124,193,0.642,43,224,267,376,69,22,192,156,949
Kevon Looney,5178572,P,25,GSW,82,80,1732,208,364,0.571,0,1,0.0,208,363,0.573,0.571,75,125,0.6,208,388,596,165,50,52,67,215,491
Khem Birch,6350000,P,29,TOR,55,28,991,97,200,0.485,0,14,0.0,97,186,0.522,0.485,53,71,0.746,122,117,239,56,30,26,29,104,247
Khris Middleton,35500000,AL,30,MIL,66,66,2141,452,1021,0.443,162,434,0.373,290,587,0.494,0.522,259,291,0.89,41,315,356,358,76,18,190,160,1325
Killian Hayes,5572680,BA,20,DET,66,40,1647,176,459,0.383,44,167,0.263,132,292,0.452,0.431,57,74,0.77,36,174,210,277,78,35,111,183,453
Killian Tillie,2000000,P,23,MEM,36,3,461,43,127,0.339,27,86,0.314,16,41,0.39,0.445,5,8,0.625,21,39,60,22,23,15,13,58,118
Kira Lewis Jr.,3822240,BA,20,NOP,24,0,341,59,146,0.404,13,58,0.224,46,88,0.523,0.449,10,12,0.833,9,30,39,49,11,1,26,17,141
Klay Thompson,37980720,ES,31,GSW,32,32,941,246,573,0.429,114,296,0.385,132,277,0.477,0.529,46,51,0.902,15,110,125,88,16,17,43,54,652
Kris Dun,334371,BA,27,POR,14,3,336,44,102,0.431,1,11,0.091,43,91,0.473,0.436,17,18,0.944,9,40,49,79,23,3,32,38,106
Kristaps Porziņģis,31650600,AP,26,WAS,51,51,1481,352,767,0.459,78,252,0.31,274,515,0.532,0.51,248,286,0.867,102,309,411,119,37,84,81,137,1030
Kyle Anderson,9937150,AP,28,MEM,69,11,1484,209,469,0.446,36,109,0.33,173,360,0.481,0.484,67,105,0.638,69,299,368,183,77,45,71,108,521
Kyle G,369999,ES,24,MIA,19,0,186,26,65,0.4,14,40,0.35,12,25,0.48,0.508,8,12,0.667,4,13,17,17,7,1,13,12,74
Kyle Kuzma,13000000,AP,26,WAS,66,66,2204,423,936,0.452,128,375,0.341,295,561,0.526,0.52,156,219,0.712,70,491,561,233,42,57,169,128,1130
Kyle Lowry,26984128,BA,35,MIA,63,63,2133,276,627,0.44,144,382,0.377,132,245,0.539,0.555,148,174,0.851,33,249,282,474,67,17,168,177,844
Kyrie Irving,35328700,BA,29,BRK,29,29,1091,289,616,0.469,100,239,0.418,189,377,0.501,0.55,118,129,0.915,16,111,127,167,41,17,73,81,796
KZ Okpala,1782621,AP,22,MIA,21,0,244,30,69,0.435,9,26,0.346,21,43,0.488,0.5,8,11,0.727,11,30,41,14,4,7,5,25,77
Lamar Stevens,1517981,AP,24,CLE,63,13,1015,156,319,0.489,18,65,0.277,138,254,0.543,0.517,53,75,0.707,47,117,164,44,31,18,41,106,383
LaMarcus Aldridge,2641691,P,36,BRK,47,12,1050,252,458,0.55,14,46,0.304,238,412,0.578,0.566,89,102,0.873,73,185,258,42,14,47,44,78,607
LaMelo Bal,8231760,BA,20,CHO,75,75,2422,538,1254,0.429,220,565,0.389,318,689,0.462,0.517,212,243,0.872,108,393,501,571,119,30,245,237,1508
Lance Stephenson,1476806,AL,31,IND,46,1,814,147,323,0.455,27,90,0.3,120,233,0.515,0.497,63,80,0.788,12,115,127,165,24,4,72,96,384
Landry Shamet,3768342,ES,24,PHO,69,14,1437,191,485,0.394,123,334,0.368,68,151,0.45,0.521,68,81,0.84,16,110,126,108,28,9,41,92,573
Larry Nance Jr.,10690909,AP,29,NOP,46,11,1040,129,247,0.522,23,70,0.329,106,177,0.599,0.569,40,57,0.702,72,176,248,81,43,20,37,84,321
Lauri Markkanen,15690909,AP,24,CLE,61,61,1878,313,703,0.445,136,380,0.358,177,323,0.548,0.542,138,159,0.868,59,286,345,81,45,30,54,130,900
Leandro Bolmaro,2353320,AL,21,MIN,35,2,241,17,54,0.315,5,18,0.278,12,36,0.333,0.361,11,13,0.846,16,27,43,21,6,0,13,26,50
LeBron James,41180544,AL,37,LAL,56,56,2084,640,1221,0.524,161,448,0.359,479,773,0.62,0.59,254,336,0.756,63,396,459,349,73,59,196,121,1695
Lonnie Walker IV,4447896,ES,23,SAS,70,6,1612,311,764,0.407,111,353,0.314,200,411,0.487,0.48,116,148,0.784,18,163,181,152,44,19,71,98,849
Lonzo Bal,18604651,BA,24,CHI,35,35,1212,162,383,0.423,110,260,0.423,52,123,0.423,0.567,21,28,0.75,35,155,190,178,64,31,82,85,455
Lou Williams,5000000,BA,35,ATL,56,0,799,125,320,0.391,37,102,0.363,88,218,0.404,0.448,67,78,0.859,16,71,87,105,28,3,43,48,354
Louis Kin,324372,AL,22,SAC,10,0,104,15,47,0.319,8,27,0.296,7,20,0.35,0.404,7,10,0.7,0,12,12,9,2,1,0,14,45
Luguentz Dor,1782621,AL,22,OKC,51,51,1665,293,726,0.404,130,391,0.332,163,335,0.487,0.493,161,191,0.843,38,174,212,88,46,18,88,149,877
Luka Dončić,10174391,BA,22,DAL,65,65,2301,641,1403,0.457,201,569,0.353,440,834,0.528,0.529,364,489,0.744,56,537,593,568,75,36,292,145,1847
Luka Garza,925258,P,23,DET,32,5,389,66,147,0.449,16,49,0.327,50,98,0.51,0.503,38,61,0.623,58,42,100,20,9,6,18,55,186
Luke Kennard,12727273,ES,25,LAC,70,13,1919,287,639,0.449,190,423,0.449,97,216,0.449,0.598,69,77,0.896,20,209,229,146,42,6,60,101,833
Luke Kornet,606702,P,26,BOS,15,0,103,13,27,0.481,0,5,0.0,13,22,0.591,0.481,4,6,0.667,13,16,29,9,3,3,0,9,30
Malachi Flynn,2048040,BA,23,TOR,44,5,537,72,183,0.393,30,90,0.333,42,93,0.452,0.475,15,24,0.625,10,53,63,70,20,4,13,45,189
Malcolm Brogdon,21700000,BA,29,IND,36,36,1206,243,543,0.448,58,186,0.312,185,357,0.518,0.501,143,167,0.856,33,152,185,212,30,14,77,71,687
Malcolm Hil,271197,ES,26,CHI,19,0,212,24,52,0.462,13,36,0.361,11,16,0.688,0.587,11,14,0.786,11,24,35,8,7,3,3,24,72
Malik Beasley,14491964,ES,25,MIN,79,18,1976,332,850,0.391,240,637,0.377,92,213,0.432,0.532,49,60,0.817,26,201,227,116,43,12,43,88,953
Malik Mon,1789256,ES,23,LAL,76,37,2139,391,826,0.473,173,442,0.391,218,384,0.568,0.578,93,117,0.795,37,219,256,218,61,29,122,138,1048
Malik Newman,85578,BA,24,CLE,1,0,8,3,5,0.6,0,1,0.0,3,4,0.75,0.6,2,2,1.0,0,1,1,1,0,0,1,0,8
Mamadi Diakite,356734,AP,25,OKC,13,3,188,25,47,0.532,0,5,0.0,25,42,0.595,0.532,6,11,0.545,17,42,59,2,5,9,7,33,56
Marcus Garrett,241950,ES,23,MIA,12,0,128,5,21,0.238,1,4,0.25,4,17,0.235,0.262,2,5,0.4,9,14,23,7,5,3,2,16,13
Marcus Morris,15627907,AP,32,LAC,54,54,1564,300,691,0.434,101,275,0.367,199,416,0.478,0.507,129,148,0.872,26,213,239,113,28,18,69,115,830
Marcus Smart,14339285,BA,27,BOS,71,71,2296,300,718,0.418,119,360,0.331,181,358,0.506,0.501,142,179,0.793,42,228,270,417,119,18,159,160,861
Markelle Fultz,16500000,BA,23,ORL,18,3,360,83,175,0.474,4,17,0.235,79,158,0.5,0.486,25,31,0.806,4,45,49,99,20,5,40,22,195
Markieff Morris,2641691,AP,32,MIA,17,1,298,54,114,0.474,13,39,0.333,41,75,0.547,0.531,8,9,0.889,17,28,45,23,6,1,20,33,129
Marko Simonovic,925258,P,22,CHI,9,0,35,4,15,0.267,1,5,0.2,3,10,0.3,0.3,8,11,0.727,5,5,10,0,1,1,2,6,17
Marquese Chriss,1292900,AP,24,DAL,34,0,346,62,134,0.463,8,25,0.32,54,109,0.495,0.493,22,33,0.667,33,70,103,17,13,12,17,64,154
Marvin Bagley III,11312114,AP,22,DET,48,25,1146,225,446,0.504,23,97,0.237,202,349,0.579,0.53,67,101,0.663,105,233,338,36,22,18,39,93,540
Mason Plumlee,9248333,P,31,CHO,73,73,1793,205,320,0.641,0,2,0.0,205,318,0.645,0.641,67,171,0.392,176,389,565,226,61,52,100,224,477
Matisse Thybulle,2840160,ES,24,PHI,66,50,1685,150,300,0.5,45,144,0.313,105,156,0.673,0.575,34,43,0.791,42,109,151,75,115,71,39,158,379
Matt Thomas,1669178,ES,27,CHI,40,0,459,55,134,0.41,35,91,0.385,20,43,0.465,0.541,16,20,0.8,3,47,50,20,8,3,8,18,161
Maurice Harkless,4330000,AL,28,SAC,47,24,863,83,181,0.459,31,101,0.307,52,80,0.65,0.544,20,28,0.714,12,100,112,23,29,24,31,77,217
Max Strus,1669178,AL,25,MIA,68,16,1587,249,564,0.441,181,442,0.41,68,122,0.557,0.602,42,53,0.792,24,178,202,92,28,16,57,116,721
Maxi Kleber,8975000,AP,30,DAL,59,21,1450,141,354,0.398,83,255,0.325,58,99,0.586,0.516,46,65,0.708,70,280,350,68,30,58,47,137,411
Micah Potter,53176,P,23,DET,3,0,31,5,11,0.455,0,2,0.0,5,9,0.556,0.455,2,2,1.0,4,5,9,0,1,1,1,4,12
Michael Porter Jr.,5258735,AL,23,DEN,9,9,265,37,103,0.359,10,48,0.208,27,55,0.491,0.408,5,9,0.556,9,50,59,17,10,2,12,16,89
Mikal Bridges,5557725,AL,25,PHO,82,82,2854,458,858,0.534,115,312,0.369,343,546,0.628,0.601,131,157,0.834,74,273,347,185,96,36,68,150,1162
Mike Conley,21000000,BA,34,UTA,72,72,2058,344,791,0.435,169,414,0.408,175,377,0.464,0.542,129,162,0.796,47,170,217,385,96,21,123,142,986
Mike Muscala,3500000,P,30,OKC,43,0,592,113,248,0.456,70,163,0.429,43,85,0.506,0.597,48,57,0.842,21,108,129,22,18,26,14,58,344
Miles Bridges,5421493,AP,23,CHO,80,80,2837,596,1214,0.491,154,465,0.331,442,749,0.59,0.554,267,333,0.802,90,469,559,300,74,67,150,193,1613
Miles McBride,925258,BA,21,NYK,40,2,372,32,108,0.296,17,68,0.25,15,40,0.375,0.375,8,12,0.667,4,38,42,41,14,1,5,45,89
Miye O,895930,ES,24,UTA,16,0,44,2,9,0.222,1,8,0.125,1,1,1.0,0.278,0,1,0.0,1,6,7,5,0,0,1,7,5
Mo Bamba,7568743,P,23,ORL,71,69,1824,296,617,0.48,107,281,0.381,189,336,0.563,0.566,57,73,0.781,148,424,572,85,38,118,77,182,756
Monte Morris,8449074,BA,26,DEN,75,74,2239,374,773,0.484,124,314,0.395,250,459,0.545,0.564,73,84,0.869,27,199,226,333,56,14,78,92,945
Montrezl Harrell,9720900,P,28,CHO,71,3,1641,358,555,0.645,4,17,0.235,354,538,0.658,0.649,212,296,0.716,149,282,431,145,29,43,72,137,932
Moritz Wagner,1729217,P,24,ORL,63,3,960,197,396,0.497,66,201,0.328,131,195,0.672,0.581,104,129,0.806,42,190,232,87,20,13,56,123,564
Moses Moody,3562080,ES,19,GSW,52,11,607,80,183,0.437,40,110,0.364,40,73,0.548,0.546,28,36,0.778,17,63,80,23,7,10,13,43,228
Myles Turner,18000000,P,25,IND,42,42,1235,200,393,0.509,61,183,0.333,139,210,0.662,0.587,79,105,0.752,65,232,297,44,28,118,54,119,540
Naji Marshall,1517981,AL,24,NOP,55,4,735,109,269,0.405,21,105,0.2,88,164,0.537,0.444,74,93,0.796,38,104,142,62,33,8,46,69,313
Nassir Little,2316240,AL,21,POR,42,23,1088,145,315,0.46,51,154,0.331,94,161,0.584,0.541,69,94,0.734,58,178,236,54,25,36,40,82,410
Naz Rei,1782621,P,22,MIN,77,6,1215,233,476,0.489,57,166,0.343,176,310,0.568,0.549,114,149,0.765,102,199,301,71,40,71,82,172,637
Nemanja Bjelica,2089448,P,33,GSW,71,0,1142,160,342,0.468,54,149,0.362,106,193,0.549,0.547,59,81,0.728,62,232,294,159,41,26,87,128,433
Nerlens Noe,8800000,P,27,NYK,25,11,562,32,60,0.533,0,3,0.0,32,57,0.561,0.533,21,30,0.7,48,93,141,23,30,31,20,67,85
Nickeil Alexander-Walker,3261480,ES,23,UTA,65,21,1466,253,680,0.372,105,338,0.311,148,342,0.433,0.449,81,109,0.743,37,150,187,156,46,23,93,103,692
Nicolas Batum,3170029,AP,33,LAC,59,54,1462,179,387,0.463,108,270,0.4,71,117,0.607,0.602,25,38,0.658,29,225,254,100,58,42,40,80,491
Nik Stauskas,423536,ES,28,BOS,8,0,39,5,14,0.357,4,10,0.4,1,4,0.25,0.5,4,6,0.667,1,2,3,2,0,0,1,1,18
Nikola Jokić,31579390,P,26,DEN,74,74,2476,764,1311,0.583,97,288,0.337,667,1023,0.652,0.62,379,468,0.81,206,813,1019,584,109,63,281,191,2004
Nikola Vučević,24000000,P,31,CHI,73,73,2418,546,1154,0.473,104,331,0.314,442,823,0.537,0.518,92,121,0.76,142,662,804,236,70,71,136,181,1288
Norman Powell,15517242,ES,28,LAC,45,41,1458,279,605,0.461,106,253,0.419,173,352,0.491,0.549,189,233,0.811,20,125,145,96,42,21,69,106,853
Obi Toppin,5105160,AP,23,NYK,72,10,1230,251,473,0.531,52,169,0.308,199,304,0.655,0.586,94,124,0.758,69,199,268,77,25,33,56,102,648
OG Anunoby,16071429,AL,24,TOR,48,48,1728,309,697,0.443,115,317,0.363,194,380,0.511,0.526,89,118,0.754,74,190,264,125,71,25,80,131,822
Olivier Sar,236633,P,22,OKC,22,2,421,58,101,0.574,13,29,0.448,45,72,0.625,0.639,24,29,0.828,34,59,93,19,6,15,22,52,153
Omer Yurtseven,1489065,P,23,MIA,56,12,706,130,247,0.526,1,11,0.091,129,236,0.547,0.528,38,61,0.623,85,209,294,49,17,20,41,84,299
Oshae Brissett,1701593,AL,23,IND,67,25,1564,208,506,0.411,83,237,0.35,125,269,0.465,0.493,114,164,0.695,108,250,358,72,44,29,54,116,613
Otto Porter Jr.,2389641,AP,28,GSW,63,15,1396,193,416,0.464,80,216,0.37,113,200,0.565,0.56,49,61,0.803,86,276,362,94,68,29,37,83,515
P.J. Tucker,7000000,AP,36,MIA,71,70,1981,207,428,0.484,80,193,0.415,127,235,0.54,0.577,45,61,0.738,100,287,387,149,58,15,66,161,539
P.J. Washington,4215120,AP,23,CHO,65,28,1768,250,532,0.47,110,301,0.365,140,231,0.606,0.573,58,81,0.716,82,255,337,147,57,61,82,152,668
Paris Bas,106352,AL,26,PHO,2,0,7,2,6,0.333,0,2,0.0,2,4,0.5,0.333,2,2,1.0,2,2,4,0,1,0,2,2,6
Pascal Siakam,33003936,AP,27,TOR,68,68,2578,596,1207,0.494,75,218,0.344,521,989,0.527,0.525,284,379,0.749,128,452,580,360,85,42,181,225,1551
Pat Connaughton,5333334,ES,29,MIL,65,19,1691,227,496,0.458,146,370,0.395,81,126,0.643,0.605,45,54,0.833,45,228,273,82,59,15,35,86,645
Patrick Beverley,14320987,BA,33,MIN,58,54,1476,177,436,0.406,83,242,0.343,94,194,0.485,0.501,96,133,0.722,62,178,240,268,67,52,73,174,533
Patrick Williams,7422000,AP,20,CHI,17,9,422,54,102,0.529,15,29,0.517,39,73,0.534,0.603,30,41,0.732,17,52,69,15,9,9,16,28,153
Patty Mills,5890000,BA,33,BRK,81,48,2346,324,794,0.408,227,568,0.4,97,226,0.429,0.551,48,59,0.814,18,138,156,183,51,17,73,112,923
Paul George,39344900,AL,31,LAC,31,31,1077,268,636,0.421,91,257,0.354,177,379,0.467,0.493,127,148,0.858,12,201,213,176,67,13,126,74,754
Paul Millsap,2641691,AP,36,PHI,33,1,376,45,115,0.391,8,35,0.229,37,80,0.463,0.426,17,24,0.708,41,73,114,29,10,13,19,67,115
Paul Ree,1517981,P,22,PHI,38,2,302,54,96,0.563,2,8,0.25,52,88,0.591,0.573,6,14,0.429,44,48,92,16,33,14,10,57,116
Paul Watson,462629,AL,27,OKC,9,3,156,12,35,0.343,6,26,0.231,6,9,0.667,0.429,1,2,0.5,3,24,27,8,3,3,4,10,31
Payton Pritchard,2137440,ES,24,BOS,71,2,1001,160,373,0.429,101,245,0.412,59,128,0.461,0.564,21,21,1.0,32,102,134,139,25,6,41,61,442
Petr Cornelie,220679,AP,26,DEN,13,0,38,5,15,0.333,1,8,0.125,4,7,0.571,0.367,3,4,0.75,7,7,14,3,1,1,4,7,14
PJ Dozier,1910860,ES,25,DEN,18,0,340,36,99,0.364,15,48,0.313,21,51,0.412,0.439,10,13,0.769,14,49,63,29,11,6,13,33,97
Precious Achiuwa,2711280,P,22,TOR,73,28,1725,265,603,0.439,56,156,0.359,209,447,0.468,0.486,78,131,0.595,146,327,473,82,37,41,84,151,664
Quentin Grimes,2168760,ES,21,NYK,46,6,786,95,235,0.404,72,189,0.381,23,46,0.5,0.557,13,19,0.684,24,70,94,44,31,11,28,72,275
Quinndary Weatherspoon,191860,ES,25,GSW,11,0,73,12,21,0.571,1,5,0.2,11,16,0.688,0.595,5,5,1.0,2,12,14,5,1,1,3,15,30
R.J. Hampton,2303040,ES,20,ORL,64,14,1402,175,457,0.383,64,183,0.35,111,274,0.405,0.453,75,117,0.641,23,171,194,158,42,13,87,101,489
Rajon Rondo,2641691,BA,35,CLE,39,1,697,68,176,0.386,31,88,0.352,37,88,0.42,0.474,19,26,0.731,15,93,108,170,30,6,68,56,186
Raul Net,2089448,BA,29,WAS,70,19,1372,204,441,0.463,35,120,0.292,169,321,0.526,0.502,83,108,0.769,13,121,134,217,55,3,79,104,526
Rayjon Tucker,98779,ES,24,MIL,5,0,71,6,9,0.667,4,5,0.8,2,4,0.5,0.889,5,7,0.714,3,5,8,10,4,0,1,5,21
Reggie Bullock,9536000,AL,30,DAL,68,37,1902,201,501,0.401,141,392,0.36,60,109,0.55,0.542,40,48,0.833,33,208,241,83,41,14,40,111,583
Reggie Jackson,10384500,ES,31,LAC,75,75,2337,479,1222,0.392,167,512,0.326,312,710,0.439,0.46,138,163,0.847,39,232,271,359,55,15,173,159,1263
Reggie Perry,256734,AP,21,IND,10,1,187,40,79,0.506,3,16,0.188,37,63,0.587,0.525,9,15,0.6,15,32,47,12,9,6,11,33,92
Richaun Holmes,10384500,P,28,SAC,45,37,1074,198,300,0.66,2,5,0.4,196,295,0.664,0.663,70,90,0.778,93,224,317,48,17,41,56,128,468
Ricky Rubio,17800000,BA,31,CLE,34,8,970,149,411,0.363,59,174,0.339,90,237,0.38,0.434,88,103,0.854,15,126,141,225,49,7,90,75,445
RJ Barrett,8623920,AL,21,NYK,70,70,2417,487,1194,0.408,138,404,0.342,349,790,0.442,0.466,290,406,0.714,66,342,408,208,43,16,151,142,1402
Robert Covington,12975471,AP,31,LAC,71,42,1940,209,498,0.42,128,339,0.378,81,159,0.509,0.548,58,69,0.841,59,332,391,92,103,91,75,190,604
Robert Williams,3661976,P,24,BOS,61,61,1804,271,368,0.736,0,1,0.0,271,367,0.738,0.736,65,90,0.722,238,350,588,121,56,134,63,137,607
Robin Lopez,5000000,P,33,ORL,36,9,612,110,199,0.553,2,6,0.333,108,193,0.56,0.558,32,54,0.593,68,58,126,54,2,18,44,67,254
Rodney Hoo,2239544,ES,29,LAC,52,0,709,58,157,0.369,30,91,0.33,28,66,0.424,0.465,17,19,0.895,15,62,77,38,15,6,11,31,163
Rodney McGruder,1939350,ES,30,DET,51,2,754,98,225,0.436,58,146,0.397,40,79,0.506,0.564,19,26,0.731,31,80,111,48,21,7,24,58,273
Romeo Langford,3804360,ES,22,SAS,48,5,771,83,191,0.435,29,85,0.341,54,106,0.509,0.51,23,42,0.548,30,78,108,21,22,16,16,47,218
Royce O'Neale,8800000,AL,28,UTA,77,77,2406,203,444,0.457,119,306,0.389,84,138,0.609,0.591,45,56,0.804,64,304,368,191,86,32,79,183,570
Rudy Gay,5890000,AP,35,UTA,55,1,1038,157,379,0.414,70,203,0.345,87,176,0.494,0.507,62,79,0.785,55,187,242,56,25,19,47,95,446
Rudy Gobert,35344828,P,29,UTA,66,66,2120,362,508,0.713,0,4,0.0,362,504,0.718,0.713,303,439,0.69,241,727,968,72,45,137,119,176,1027
Rui Hachimura,4916160,AP,23,WAS,42,13,943,187,381,0.491,55,123,0.447,132,258,0.512,0.563,46,66,0.697,25,135,160,48,23,9,33,53,475
Russell Westbrook,44211146,BA,33,LAL,78,78,2678,548,1233,0.444,79,265,0.298,469,968,0.485,0.476,266,399,0.667,110,470,580,550,75,20,295,235,1441
Saben L,1489065,BA,22,DET,37,0,604,69,177,0.39,14,60,0.233,55,117,0.47,0.429,56,71,0.789,18,69,87,107,36,12,36,44,208
Saddiq B,2824320,AL,22,DET,82,82,2704,450,1136,0.396,211,610,0.346,239,526,0.454,0.489,210,254,0.827,107,334,441,233,73,16,96,128,1321
Sam Merrill,1517981,ES,25,MEM,6,0,58,8,24,0.333,7,23,0.304,1,1,1.0,0.479,2,4,0.5,1,6,7,4,0,0,2,3,25
Santi Aldama,1994520,AP,21,MEM,32,0,360,53,132,0.402,6,48,0.125,47,84,0.56,0.424,20,32,0.625,33,54,87,21,6,10,16,36,132
Scottie Barnes,7280520,AP,20,TOR,74,74,2617,459,932,0.492,58,193,0.301,401,739,0.543,0.524,158,215,0.735,195,362,557,256,80,55,136,192,1134
Semi Ojeleye,1789256,AP,27,LAC,30,0,406,30,99,0.303,15,50,0.3,15,49,0.306,0.379,23,29,0.793,27,47,74,9,7,6,9,30,98
Serge Ibaka,9720900,AP,32,MIL,54,12,877,148,296,0.5,37,99,0.374,111,197,0.563,0.563,32,44,0.727,62,188,250,49,11,33,43,102,365
Seth Curry,8207518,ES,31,BRK,64,64,2135,360,739,0.487,158,374,0.422,202,365,0.553,0.594,82,94,0.872,21,179,200,230,53,14,109,148,960
Shai Gilgeous-Alexander,5495532,BA,23,OKC,56,56,1942,477,1052,0.453,89,297,0.3,388,755,0.514,0.496,328,405,0.81,37,241,278,331,71,46,154,142,1371
Shake Milton,1846738,BA,25,PHI,55,6,1179,173,403,0.429,43,133,0.323,130,270,0.481,0.483,61,73,0.836,30,112,142,139,28,17,44,99,450
Skylar May,496860,ES,24,ATL,28,5,220,32,64,0.5,8,25,0.32,24,39,0.615,0.563,8,9,0.889,5,20,25,17,7,0,10,9,80
Spencer Dinwiddie,17142857,BA,28,DAL,67,51,1980,306,735,0.416,112,330,0.339,194,405,0.479,0.493,195,252,0.774,45,234,279,346,44,13,104,150,919
Stanley Johnson,1248865,AP,25,LAL,48,27,1094,117,251,0.466,33,105,0.314,84,146,0.575,0.532,53,74,0.716,34,121,155,80,43,14,35,109,320
Stephen Curry,45780966,BA,33,GSW,64,64,2211,535,1224,0.437,285,750,0.38,250,474,0.527,0.554,275,298,0.923,34,301,335,404,85,23,206,130,1630
Sterling Brown,3000000,ES,26,DAL,49,3,628,59,155,0.381,28,92,0.304,31,63,0.492,0.471,14,15,0.933,26,123,149,34,14,7,23,56,160
Steven Adams,17073171,P,28,MEM,76,75,1999,210,384,0.547,0,1,0.0,210,383,0.548,0.547,108,199,0.543,349,411,760,256,65,60,115,153,528
Svi Mykhailiuk,1729217,AL,24,TOR,56,5,716,91,234,0.389,41,134,0.306,50,100,0.5,0.476,32,37,0.865,20,72,92,45,26,4,32,54,255
T.J. McConnell,7500000,BA,29,IND,27,8,652,100,208,0.481,10,33,0.303,90,175,0.514,0.505,19,23,0.826,20,70,90,131,29,10,29,53,229
Taj Gibson,4910000,P,36,NYK,52,4,946,86,166,0.518,15,38,0.395,71,128,0.555,0.563,42,52,0.808,88,141,229,32,22,40,27,137,229
Talen Horton-Tucker,9500000,ES,21,LAL,60,19,1511,224,538,0.416,49,182,0.269,175,356,0.492,0.462,100,125,0.8,37,156,193,159,59,29,82,148,597
Taurean Prince,13000000,AP,27,MIN,69,8,1177,177,390,0.454,86,229,0.376,91,161,0.565,0.564,62,82,0.756,26,148,174,68,47,23,53,116,502
Terance Man,1782621,AL,25,LAC,81,33,2317,334,690,0.484,76,208,0.365,258,482,0.535,0.539,128,164,0.78,104,321,425,209,55,21,84,178,872
Terence Davis,4000000,ES,24,SAC,30,11,536,113,267,0.423,49,149,0.329,64,118,0.542,0.515,36,44,0.818,11,83,94,40,25,11,33,70,311
Terrence Ros,12500000,ES,30,ORL,63,0,1448,220,554,0.397,77,264,0.292,143,290,0.493,0.467,112,130,0.862,20,141,161,116,28,12,75,68,629
Terry Rozier,17905263,ES,27,CHO,73,73,2458,518,1167,0.444,222,593,0.374,296,574,0.516,0.539,150,176,0.852,56,259,315,326,93,25,96,119,1408
Terry Taylor,321713,ES,22,IND,33,7,714,135,220,0.614,12,38,0.316,123,182,0.676,0.641,36,51,0.706,95,77,172,41,14,8,23,61,318
Thaddeus Young,14190000,AP,33,TOR,52,1,845,141,272,0.518,17,48,0.354,124,224,0.554,0.55,23,49,0.469,80,128,208,104,54,18,52,81,322
Thanasis Antetokounmpo,1729217,AL,29,MIL,48,6,473,70,128,0.547,2,14,0.143,68,114,0.596,0.555,29,46,0.63,40,61,101,22,16,12,26,68,171
Théo Maledon,2000000,BA,20,OKC,51,7,908,119,317,0.375,44,150,0.293,75,167,0.449,0.445,79,100,0.79,20,111,131,111,31,11,65,67,361
Theo Pinson,440710,AL,26,DAL,19,0,148,14,39,0.359,10,30,0.333,4,9,0.444,0.487,10,10,1.0,2,19,21,17,5,2,5,12,48
Thomas Bryant,8666667,P,24,WAS,27,9,439,77,148,0.52,12,42,0.286,65,106,0.613,0.561,35,40,0.875,26,82,108,23,6,21,19,43,201
Tim Frazier,228709,BA,31,CLE,12,3,208,14,45,0.311,6,17,0.353,8,28,0.286,0.378,5,9,0.556,5,14,19,34,3,1,15,27,39
Tim Hardaway Jr.,21306816,ES,29,DAL,42,20,1245,209,530,0.394,102,304,0.336,107,226,0.473,0.491,78,103,0.757,13,143,156,92,38,6,34,74,598
Timothé Luwawu-Cabarrot,1939350,AL,26,ATL,52,18,685,74,186,0.398,44,122,0.361,30,64,0.469,0.516,35,41,0.854,17,65,82,40,18,6,20,76,227
Tobias Harris,35995950,AP,29,PHI,73,73,2543,493,1022,0.482,101,275,0.367,392,747,0.525,0.532,170,202,0.842,77,419,496,252,47,43,116,164,1257
Tomáš Satoranský,9468119,ES,30,WAS,55,13,906,72,191,0.377,11,53,0.208,61,138,0.442,0.406,43,54,0.796,27,99,126,184,29,5,46,71,198
Tony Snell,2389641,ES,30,NOP,53,12,823,69,171,0.404,45,128,0.352,24,43,0.558,0.535,4,4,1.0,16,87,103,28,16,9,19,70,187
Torrey Craig,4878049,AL,31,PHO,78,16,1596,200,441,0.454,77,234,0.329,123,207,0.594,0.541,39,52,0.75,86,224,310,91,46,36,67,151,516
Trae Young,8326471,BA,23,ATL,76,76,2652,711,1544,0.46,233,610,0.382,478,934,0.512,0.536,500,553,0.904,50,234,284,737,72,7,303,128,2155
Tre Jones,1517981,BA,22,SAS,69,11,1148,166,339,0.49,10,51,0.196,156,288,0.542,0.504,71,91,0.78,29,126,155,233,42,7,46,78,413
Tre Man,2901240,BA,20,OKC,60,26,1367,231,588,0.393,98,272,0.36,133,316,0.421,0.476,65,82,0.793,25,146,171,91,47,12,71,102,625
Trendon Watford,723190,AL,21,POR,48,10,869,142,267,0.532,9,38,0.237,133,229,0.581,0.549,71,94,0.755,57,142,199,81,25,28,44,116,364
Trent Forrest,471187,BA,23,UTA,60,6,765,76,155,0.49,5,27,0.185,71,128,0.555,0.506,38,48,0.792,23,76,99,106,30,6,48,43,195
Trevor Ariza,2641691,AL,36,LAL,24,11,462,33,99,0.333,20,74,0.27,13,25,0.52,0.434,10,18,0.556,10,72,82,27,13,6,11,20,96
Trey Burke,3150000,BA,29,DAL,42,0,441,84,215,0.391,26,82,0.317,58,133,0.436,0.451,20,23,0.87,4,29,33,57,12,0,26,39,214
Trey Lyles,2500000,AP,26,SAC,75,23,1537,262,562,0.466,67,209,0.321,195,353,0.552,0.526,195,243,0.802,89,290,379,88,29,32,73,123,786
Trey Murphy III,3053760,AL,21,NOP,62,1,864,109,277,0.394,71,186,0.382,38,91,0.418,0.522,45,51,0.882,47,100,147,38,23,7,16,60,334
Tristan Thompson,8774289,AP,30,CHI,57,6,897,141,267,0.528,1,3,0.333,140,264,0.53,0.53,61,116,0.526,120,168,288,34,23,21,45,98,344
Troy Brown Jr.,5170564,AL,22,CHI,66,7,1055,108,258,0.419,47,133,0.353,61,125,0.488,0.51,20,26,0.769,39,164,203,66,36,5,26,62,283
Ty Jerome,2412840,ES,24,OKC,48,4,801,124,328,0.378,54,186,0.29,70,142,0.493,0.46,38,47,0.809,19,59,78,109,30,5,37,73,340
Tyler Herro,4004280,ES,22,MIA,66,10,2151,501,1122,0.447,175,439,0.399,326,683,0.477,0.525,190,219,0.868,32,297,329,263,44,8,174,95,1367
Tyrese Haliburton,4023600,ES,21,IND,77,77,2695,430,909,0.473,161,389,0.414,269,520,0.517,0.562,160,190,0.842,61,250,311,628,134,49,199,121,1181
Tyrese Maxey,2602920,BA,21,PHI,75,74,2650,483,995,0.485,132,309,0.427,351,686,0.512,0.552,213,246,0.866,26,214,240,321,55,32,88,156,1311
Tyrone Wallace,198760,ES,27,NOP,6,0,75,7,20,0.35,2,8,0.25,5,12,0.417,0.4,1,5,0.2,0,8,8,1,3,1,2,7,17
Tyus Jones,8376286,BA,25,MEM,73,23,1549,249,552,0.451,80,205,0.39,169,347,0.487,0.524,54,66,0.818,17,159,176,324,66,2,46,32,632
Udonis Haslem,2641691,P,41,MIA,13,0,83,14,31,0.452,1,4,0.25,13,27,0.481,0.468,3,3,1.0,4,21,25,4,1,1,5,15,32
Usman Garuba,2353320,AP,19,HOU,24,2,239,19,44,0.432,5,20,0.25,14,24,0.583,0.489,5,7,0.714,21,62,83,17,10,11,6,28,48
Victor Oladipo,2389641,ES,29,MIA,8,1,173,35,73,0.479,15,36,0.417,20,37,0.541,0.582,14,19,0.737,3,20,23,28,5,1,16,13,99
Vit Krejci,925258,ES,21,OKC,30,8,690,68,167,0.407,32,98,0.327,36,69,0.522,0.503,19,22,0.864,18,83,101,57,19,8,29,65,187
Vlatko Čančar,1782621,AP,24,DEN,15,1,176,23,41,0.561,7,12,0.583,16,29,0.552,0.646,9,14,0.643,8,23,31,17,2,3,9,18,62
Wayne Ellington,2641691,ES,34,LAL,43,9,810,98,237,0.414,82,211,0.389,16,26,0.615,0.586,9,11,0.818,10,67,77,30,23,5,19,42,287
Wayne Selden,785104,ES,27,NYK,3,0,19,1,4,0.25,1,2,0.5,0,2,0.0,0.375,2,4,0.5,0,1,1,1,0,0,0,1,5
Wendell Carter Jr.,6920027,P,22,ORL,62,61,1852,359,684,0.525,70,214,0.327,289,470,0.615,0.576,143,207,0.691,139,509,648,171,36,43,117,169,931
Wenyen Gabriel,137789,AP,24,LAL,26,5,358,54,110,0.491,8,28,0.286,46,82,0.561,0.527,25,42,0.595,39,58,97,14,5,11,16,68,141
Wes Iwundu,1802831,AL,27,ATL,3,1,82,8,18,0.444,3,5,0.6,5,13,0.385,0.528,3,4,0.75,3,10,13,0,1,0,1,8,22
Wesley Matthews,1958495,ES,35,MIL,49,14,1002,87,220,0.395,53,157,0.338,34,63,0.54,0.516,22,28,0.786,30,62,92,36,23,8,18,87,249
Will Barton,15625000,ES,31,DEN,71,71,2277,392,896,0.438,157,430,0.365,235,466,0.504,0.525,102,127,0.803,44,296,340,276,55,31,127,114,1043
Willie Cauley-Stein,4120083,P,28,PHI,20,2,183,16,35,0.457,1,2,0.5,15,33,0.455,0.471,1,2,0.5,13,27,40,10,6,3,7,19,34
Willy Hernangómez,2327220,P,27,NOP,50,8,839,170,327,0.52,4,12,0.333,166,315,0.527,0.526,109,141,0.773,143,195,338,63,21,19,51,97,453
Xavier Tillman Sr.,1517981,AP,23,MEM,53,2,701,98,216,0.454,10,49,0.204,88,167,0.527,0.477,46,71,0.648,66,95,161,62,49,15,34,63,252
Yuta Watanabe,1762796,AL,27,TOR,38,4,445,56,138,0.406,27,79,0.342,29,59,0.492,0.504,24,40,0.6,18,74,92,21,11,16,19,38,163
Zach Collins,7000000,AP,24,SAS,28,4,502,76,155,0.49,14,41,0.341,62,114,0.544,0.535,52,65,0.8,46,107,153,61,13,23,45,67,218
Zach LaVine,19500000,AL,26,CHI,67,67,2328,565,1186,0.476,185,475,0.389,380,711,0.534,0.554,320,375,0.853,22,286,308,303,41,23,171,120,1635
Zavier Simpson,53176,BA,24,OKC,4,4,174,19,52,0.365,1,8,0.125,18,44,0.409,0.375,5,5,1.0,2,19,21,30,5,4,10,15,44
Zeke Nnaji,2498760,AP,21,DEN,41,1,698,96,186,0.516,37,80,0.463,59,106,0.557,0.616,41,65,0.631,56,91,147,17,16,13,23,79,270
Ziaire Williams,4373160,AL,20,MEM,62,31,1346,191,424,0.45,76,242,0.314,115,182,0.632,0.54,43,55,0.782,26,103,129,65,35,12,41,113,501
Doug McDermott,13750000,AL,31,SAS,64,0,1314,239,523,0.457,123,298,0.413,116,225,0.516,0.575,53,70,0.757,24,115,139,91,13,6,58,118,654
Devonte' Graham,11550000,BA,27,TOT,73,8,1338,161,431,0.374,119,338,0.352,42,93,0.452,0.512,98,131,0.748,19,103,122,196,45,16,53,79,539
Zach Collins,7350000,P,25,SAS,63,26,1441,284,548,0.518,55,147,0.374,229,401,0.571,0.568,108,142,0.761,116,286,402,180,37,49,129,199,731
Khem Birch,6667500,P,30,TOR,20,0,162,19,32,0.594,1,2,0.5,18,30,0.6,0.609,4,5,0.8,8,17,25,7,5,5,8,24,43
Romeo Langford,5634257,ES,23,SAS,43,21,844,121,259,0.467,16,61,0.262,105,198,0.53,0.498,39,56,0.696,57,57,114,50,24,13,30,67,297
Jeremy Sochan,5063520,AP,19,SAS,56,53,1458,250,552,0.453,33,134,0.246,217,418,0.519,0.483,81,116,0.698,95,200,295,142,43,23,97,138,614
Dewayne Dedmon,4700000,P,33,TOT,38,1,426,77,151,0.51,12,39,0.308,65,112,0.58,0.55,33,49,0.673,34,100,134,26,9,19,25,75,199
Dewayne Dedmon,2748674,P,33,TOT,38,1,426,77,151,0.51,12,39,0.308,65,112,0.58,0.55,33,49,0.673,34,100,134,26,9,19,25,75,199
Dewayne Dedmon,580373,P,33,TOT,38,1,426,77,151,0.51,12,39,0.308,65,112,0.58,0.55,33,49,0.673,34,100,134,26,9,19,25,75,199
Devin Vassell,4437000,ES,22,SAS,38,32,1178,261,595,0.439,103,266,0.387,158,329,0.48,0.525,78,100,0.78,8,140,148,136,43,17,57,57,703
Joshua Primo,4144320,ES,20,SAS,4,0,93,9,26,0.346,3,12,0.25,6,14,0.429,0.404,7,9,0.778,2,11,13,18,1,2,11,8,28
Keldon Johnson,3873025,AL,23,SAS,63,63,2063,503,1113,0.452,134,407,0.329,369,706,0.523,0.512,245,327,0.749,56,262,318,183,46,11,134,125,1385
Malaki Branham,2925600,ES,19,SAS,66,32,1550,269,611,0.44,77,255,0.302,192,356,0.539,0.503,58,70,0.829,28,153,181,127,33,7,76,115,673
Blake Wesley,2385480,ES,19,SAS,37,1,669,69,215,0.321,20,52,0.385,49,163,0.301,0.367,26,44,0.591,11,70,81,99,25,5,65,67,184
Isaiah Roby,1930681,AP,24,SAS,42,2,474,67,155,0.432,18,60,0.3,49,95,0.516,0.49,20,41,0.488,21,86,107,38,18,7,31,53,172
Isaiah Roby,400000,AP,24,SAS,42,2,474,67,155,0.432,18,60,0.3,49,95,0.516,0.49,20,41,0.488,21,86,107,38,18,7,31,53,172
Keita Bates-Diop,1878720,AP,27,SAS,67,42,1452,236,465,0.508,56,142,0.394,180,323,0.557,0.568,119,150,0.793,65,183,248,103,46,20,56,63,647
Gorgui Dieng,105522,P,33,SAS,31,1,358,45,117,0.385,21,75,0.28,24,42,0.571,0.474,10,13,0.769,27,80,107,53,4,14,32,57,121
Tre Jones,1782621,BA,23,SAS,68,65,1984,341,743,0.459,45,158,0.285,296,585,0.506,0.489,148,172,0.86,56,189,245,448,89,9,110,98,875
Stanley Johnson,1245164,AL,26,SAS,30,0,469,65,122,0.533,18,40,0.45,47,82,0.573,0.607,26,39,0.667,22,73,95,67,16,6,33,48,174
Stanley Johnson,2351521,AL,26,SAS,30,0,469,65,122,0.533,18,40,0.45,47,82,0.573,0.607,26,39,0.667,22,73,95,67,16,6,33,48,174
Noah Vonleh,1160955,P,27,BOS,23,1,171,11,24,0.458,1,4,0.25,10,20,0.5,0.479,2,2,1.0,18,30,48,7,2,8,11,35,25
Alize Johnson,192293,AP,26,SAS,4,0,30,3,6,0.5,0,2,0.0,3,4,0.75,0.5,1,2,0.5,2,8,10,1,1,0,4,3,7
John Wall,40866760,BA,32,LAC,34,3,755,138,338,0.408,33,109,0.303,105,229,0.459,0.457,77,113,0.681,14,78,92,178,27,12,80,59,386
Danny Green,9710528,ES,35,TOT,11,0,138,22,49,0.449,16,37,0.432,6,12,0.5,0.612,1,1,1.0,3,11,14,6,6,3,10,16,61
Danny Green,2000000,ES,35,TOT,11,0,138,22,49,0.449,16,37,0.432,6,12,0.5,0.612,1,1,1.0,3,11,14,6,6,3,10,16,61
Jalen Green,9441840,ES,20,HOU,76,76,2602,566,1359,0.416,187,554,0.338,379,805,0.471,0.485,364,463,0.786,43,241,284,281,59,18,200,131,1683
Jae'Sean Tate,7065217,AL,27,HOU,31,7,677,110,229,0.48,13,46,0.283,97,183,0.53,0.509,50,69,0.725,41,77,118,84,21,7,47,106,283
Justin Holiday,6292440,AL,33,TOT,46,2,706,77,204,0.377,46,143,0.322,31,61,0.508,0.49,5,8,0.625,5,50,55,41,19,19,22,68,205
Justin Holiday,569821,AL,33,TOT,46,2,706,77,204,0.377,46,143,0.322,31,61,0.508,0.49,5,8,0.625,5,50,55,41,19,19,22,68,205
Ty Jerome,4220057,ES,25,GSW,45,2,816,118,242,0.488,35,90,0.389,83,152,0.546,0.56,38,41,0.927,7,71,78,135,23,5,30,64,309
Boban Marjanović,601478,P,34,HOU,31,0,171,41,60,0.683,0,1,0.0,41,59,0.695,0.683,20,27,0.741,20,40,60,9,5,2,14,10,102
Tari Eason,3359160,AP,21,HOU,82,5,1767,296,660,0.448,59,172,0.343,237,488,0.486,0.493,109,145,0.752,195,301,496,88,96,47,101,189,760
Usman Garuba,2471160,P,20,HOU,75,1,970,86,177,0.486,24,59,0.407,62,118,0.525,0.554,29,47,0.617,120,187,307,64,44,29,47,135,225
Josh Christopher,2372160,ES,21,HOU,64,2,786,153,329,0.465,21,89,0.236,132,240,0.55,0.497,45,60,0.75,20,51,71,73,33,15,60,59,372
Théo Maledon,1900000,BA,21,CHO,44,7,854,102,254,0.402,28,95,0.295,74,159,0.465,0.457,63,74,0.851,14,109,123,152,37,12,59,61,295
Frank Kaminsky,1836090,P,29,TOT,36,0,235,31,63,0.492,13,33,0.394,18,30,0.6,0.595,14,16,0.875,7,45,52,32,6,4,9,22,89
Daishen Nix,1563518,BA,20,HOU,57,7,914,81,237,0.342,40,140,0.286,41,97,0.423,0.426,24,36,0.667,18,80,98,132,31,7,86,59,226
Damian Lillard,42492492,BA,32,POR,58,58,2107,556,1202,0.463,244,658,0.371,312,544,0.574,0.564,510,558,0.914,44,233,277,425,50,18,191,109,1866
Anfernee Simons,22321429,ES,23,POR,62,62,2171,467,1045,0.447,212,562,0.377,255,483,0.528,0.548,160,179,0.894,18,143,161,253,42,14,128,142,1306
Jerami Grant,20955000,AP,28,POR,63,63,2246,434,913,0.475,144,359,0.401,290,554,0.523,0.554,278,342,0.813,53,230,283,150,51,53,116,152,1290
Jusuf Nurkić,15625000,P,28,POR,52,52,1391,262,505,0.519,43,119,0.361,219,386,0.567,0.561,127,192,0.661,114,357,471,149,43,44,119,185,694
Shaedon Sharpe,6012960,ES,19,POR,80,15,1779,306,648,0.472,102,283,0.36,204,365,0.559,0.551,75,105,0.714,63,173,236,94,38,24,83,136,789
Cam Reddish,5954454,AL,23,TOT,40,20,990,139,312,0.446,45,144,0.313,94,168,0.56,0.518,64,75,0.853,18,70,88,57,39,14,47,72,387
Matisse Thybulle,4379527,ES,25,TOT,71,28,1200,110,253,0.435,54,148,0.365,56,105,0.533,0.542,19,28,0.679,40,100,140,53,83,32,24,113,293
Nassir Little,4171548,AL,22,POR,54,4,976,134,303,0.442,58,158,0.367,76,145,0.524,0.538,33,46,0.717,27,114,141,50,20,20,36,66,359
Justise Winslow,4097561,AP,26,POR,29,11,776,81,198,0.409,14,45,0.311,67,153,0.438,0.444,20,28,0.714,49,96,145,98,30,11,43,89,196
Kevin Knox,3000000,AL,23,TOT,63,5,952,152,332,0.458,65,186,0.349,87,146,0.596,0.556,46,60,0.767,34,143,177,33,24,12,50,95,415
Keon Johnson,2681040,ES,20,POR,40,0,416,67,178,0.376,28,81,0.346,39,97,0.402,0.455,27,41,0.659,11,33,44,59,19,6,43,43,189
Drew Eubanks,1836090,P,25,POR,78,28,1584,214,334,0.641,7,18,0.389,207,316,0.655,0.651,83,125,0.664,132,286,418,103,40,102,67,169,518
Trendon Watford,1563518,AP,22,POR,62,12,1182,181,323,0.56,25,64,0.391,156,259,0.602,0.599,72,100,0.72,42,196,238,130,32,12,71,118,459
Jabari Walker,1017781,AL,20,POR,56,0,619,83,198,0.419,16,56,0.286,67,142,0.472,0.46,34,45,0.756,48,83,131,34,10,13,29,69,216
Shaquille Harrison,105522,ES,29,POR,5,0,120,15,36,0.417,3,10,0.3,12,26,0.462,0.458,11,15,0.733,1,21,22,30,11,2,6,12,44
Shaquille Harrison,12260,ES,29,POR,5,0,120,15,36,0.417,3,10,0.3,12,26,0.462,0.458,11,15,0.733,1,21,22,30,11,2,6,12,44
Skylar Mays,10552,BA,25,POR,6,6,189,34,68,0.5,12,26,0.462,22,42,0.524,0.588,12,13,0.923,2,17,19,50,6,1,10,11,92
Jeenathan Williams,52644,ES,23,POR,5,4,127,24,39,0.615,3,8,0.375,21,31,0.677,0.654,2,3,0.667,10,5,15,10,3,2,4,13,53
Justin Minaya,35096,AL,23,POR,4,0,89,7,23,0.304,3,12,0.25,4,11,0.364,0.37,0,1,0.0,3,12,15,4,2,5,4,9,17
Russell Westbrook,46295265,BA,34,TOT,73,24,2126,432,991,0.436,89,286,0.311,343,705,0.487,0.481,206,314,0.656,89,334,423,551,76,33,255,162,1159
Russell Westbrook,495955,BA,34,TOT,73,24,2126,432,991,0.436,89,286,0.311,343,705,0.487,0.481,206,314,0.656,89,334,423,551,76,33,255,162,1159
Collin Sexton,16500000,BA,24,UTA,48,15,1145,237,468,0.506,48,122,0.393,189,346,0.546,0.558,163,199,0.819,37,68,105,138,27,6,85,112,685
Lauri Markkanen,16475454,AP,25,UTA,66,66,2273,571,1145,0.499,200,511,0.391,371,634,0.585,0.586,349,399,0.875,130,440,570,123,42,38,127,137,1691
Jordan Clarkson,13340000,ES,30,UTA,61,61,1988,458,1031,0.444,155,459,0.338,303,572,0.53,0.519,200,245,0.816,72,174,246,270,33,13,186,120,1271
Kelly Olynyk,12804878,P,31,UTA,68,68,1942,278,557,0.499,93,236,0.394,185,321,0.576,0.583,198,232,0.853,82,338,420,252,60,37,168,232,847
Talen Horton-Tucker,10260000,ES,22,UTA,65,20,1313,257,613,0.419,58,203,0.286,199,410,0.485,0.467,126,168,0.75,41,169,210,246,41,29,126,108,698
Rudy Gay,6184500,AP,36,UTA,56,0,816,109,287,0.38,33,130,0.254,76,157,0.484,0.437,42,49,0.857,33,130,163,57,19,18,37,68,293
Ochai Agbaji,3918360,ES,22,UTA,59,22,1209,165,386,0.427,81,228,0.355,84,158,0.532,0.532,56,69,0.812,43,78,121,67,16,15,41,99,467
Simone Fontecchio,3205128,AL,27,UTA,52,6,766,115,312,0.369,63,191,0.33,52,121,0.43,0.47,35,44,0.795,31,55,86,42,15,8,39,62,328
Walker Kessler,2696400,P,21,UTA,74,40,1703,298,414,0.72,1,3,0.333,297,411,0.723,0.721,82,159,0.516,231,389,620,69,26,173,58,169,679
Damian Jones,2298385,P,27,TOT,41,1,477,55,86,0.64,10,17,0.588,45,69,0.652,0.698,22,29,0.759,42,80,122,15,8,21,23,55,142
Juan Toscano-Anderson,1836090,AL,29,TOT,52,9,700,64,143,0.448,8,43,0.186,56,100,0.56,0.476,19,24,0.792,28,96,124,65,16,10,34,80,155
Saben Lee,1752638,BA,23,TOT,25,1,373,49,121,0.405,11,30,0.367,38,91,0.418,0.45,42,57,0.737,13,32,45,67,19,1,24,32,151
Saben Lee,10492,BA,23,TOT,25,1,373,49,121,0.405,11,30,0.367,38,91,0.418,0.45,42,57,0.737,13,32,45,67,19,1,24,32,151
Kris Dunn,105522,BA,28,UTA,22,3,568,116,216,0.537,17,36,0.472,99,180,0.55,0.576,41,53,0.774,9,91,100,124,25,10,35,58,290
Luka Šamanić,105522,AP,23,UTA,7,4,161,26,57,0.456,8,31,0.258,18,26,0.692,0.526,9,13,0.692,0,30,30,15,6,2,10,17,69
Jarrell Brantley,105522,AP,26,UTA,4,0,39,8,14,0.571,4,9,0.444,4,5,0.8,0.714,2,2,1.0,1,5,6,3,0,2,2,3,22
Kyrie Irving,38917057,BA,30,TOT,60,60,2241,594,1203,0.494,188,496,0.379,406,707,0.574,0.572,247,273,0.905,59,245,304,331,66,45,128,165,1623
Luka Dončić,37096500,BA,23,DAL,66,66,2391,719,1449,0.496,185,541,0.342,534,908,0.588,0.56,515,694,0.742,54,515,569,529,90,33,236,166,2138
Dāvis Bertāns,16000000,AP,30,DAL,45,1,492,69,160,0.431,55,141,0.39,14,19,0.737,0.603,13,15,0.867,10,43,53,21,11,8,10,53,206
Christian Wood,14317459,P,27,DAL,67,17,1738,396,769,0.515,105,279,0.376,291,490,0.594,0.583,217,281,0.772,87,404,491,121,30,72,121,169,1114
Dwight Powell,11080125,P,31,DAL,76,64,1458,197,269,0.732,0,5,0.0,197,264,0.746,0.732,112,168,0.667,149,165,314,69,48,26,65,209,506
Reggie Bullock,10012800,AL,31,DAL,78,55,2364,192,470,0.409,151,397,0.38,41,73,0.562,0.569,26,37,0.703,32,251,283,108,54,13,36,166,561
Maxi Kleber,9000000,AP,31,DAL,37,5,930,77,169,0.456,39,112,0.348,38,57,0.667,0.571,27,38,0.711,30,105,135,52,12,30,27,85,220
JaVale McGee,5461219,P,35,DAL,42,7,355,80,125,0.64,2,5,0.4,78,120,0.65,0.648,24,41,0.585,30,77,107,11,4,26,36,54,186
Josh Green,3098400,ES,22,DAL,60,21,1539,205,382,0.537,68,169,0.402,137,213,0.643,0.626,68,94,0.723,55,127,182,103,42,5,72,156,546
Frank Ntilikina,2036318,ES,24,DAL,47,5,607,48,132,0.364,17,67,0.254,31,65,0.477,0.428,22,33,0.667,7,55,62,58,16,7,29,65,135
Theo Pinson,1836090,ES,27,DAL,40,1,323,31,87,0.356,22,62,0.355,9,25,0.36,0.483,11,13,0.846,10,53,63,46,6,1,12,34,95
Markieff Morris,1836090,AP,33,TOT,35,2,355,47,115,0.409,28,71,0.394,19,44,0.432,0.53,10,10,1.0,13,58,71,31,9,5,18,48,132
Jaden Hardy,1017781,ES,20,DAL,48,5,708,146,333,0.438,63,156,0.404,83,177,0.469,0.533,65,79,0.823,11,78,89,65,17,7,46,64,420
Kemba Walker,684712,BA,32,DAL,9,1,144,24,57,0.421,7,28,0.25,17,29,0.586,0.482,17,21,0.81,3,13,16,19,2,2,4,11,72
Kemba Walker,27431078,BA,32,DAL,9,1,144,24,57,0.421,7,28,0.25,17,29,0.586,0.482,17,21,0.81,3,13,16,19,2,2,4,11,72
Kemba Walker,9165471,BA,32,DAL,9,1,144,24,57,0.421,7,28,0.25,17,29,0.586,0.482,17,21,0.81,3,13,16,19,2,2,4,11,72
Facundo Campazzo,464299,BA,31,DAL,8,0,52,3,13,0.231,3,11,0.273,0,2,0.0,0.346,1,2,0.5,0,2,2,9,6,0,3,3,10
CJ McCollum,33333333,BA,31,NOP,75,75,2649,587,1344,0.437,211,543,0.389,376,801,0.469,0.515,183,238,0.769,55,273,328,429,70,38,183,153,1568
Brandon Ingram,31650600,AL,25,NOP,45,45,1538,404,835,0.484,64,164,0.39,340,671,0.507,0.522,240,272,0.882,23,223,246,262,32,19,148,116,1112
Jonas Valančiūnas,14700000,P,30,NOP,79,79,1968,446,816,0.547,38,109,0.349,408,707,0.577,0.57,185,224,0.826,225,579,804,140,20,52,159,245,1115
Zion Williamson,13534817,AP,22,NOP,29,29,956,285,469,0.608,7,19,0.368,278,450,0.618,0.615,177,248,0.714,58,144,202,133,32,16,99,65,754
Josh Richardson,12196094,ES,29,TOT,65,10,1530,239,554,0.431,107,293,0.365,132,261,0.506,0.528,69,81,0.852,41,134,175,174,69,20,86,117,654
Jaxson Hayes,6803012,P,22,NOP,47,2,610,86,156,0.551,3,29,0.103,83,127,0.654,0.561,58,83,0.699,39,93,132,34,20,19,31,67,233
Dyson Daniels,5508600,BA,19,NOP,59,11,1042,87,208,0.418,27,86,0.314,60,122,0.492,0.483,26,40,0.65,36,152,188,134,43,11,57,99,227
Garrett Temple,5155500,ES,36,NOP,25,0,162,18,45,0.4,11,26,0.423,7,19,0.368,0.522,3,4,0.75,5,12,17,13,9,2,4,15,50
Willy Hernangómez,2443581,P,28,NOP,38,2,458,89,169,0.527,3,11,0.273,86,158,0.544,0.536,81,104,0.779,58,122,180,33,17,13,39,64,262
Herbert Jones,1785000,AP,24,NOP,66,66,1951,235,501,0.469,56,167,0.335,179,334,0.536,0.525,123,161,0.764,97,172,269,162,103,42,88,208,649
Naji Marshall,1782621,AL,25,NOP,77,21,1792,247,571,0.433,66,218,0.303,181,353,0.513,0.49,138,175,0.789,48,231,279,189,54,14,97,113,698
Jose Alvarado,1563518,BA,24,NOP,61,10,1310,201,489,0.411,83,247,0.336,118,242,0.488,0.496,65,80,0.813,28,113,141,186,67,10,81,125,550
Shai Gilgeous-Alexander,30913750,BA,24,OKC,68,68,2416,704,1381,0.51,58,168,0.345,646,1213,0.533,0.531,669,739,0.905,59,270,329,371,112,65,192,192,2135
Luguentz Dort,15277778,AL,23,OKC,74,73,2272,339,873,0.388,135,409,0.33,204,464,0.44,0.466,200,259,0.772,128,216,344,154,75,23,92,243,1013
Dario Šarić,9240000,P,28,TOT,57,12,806,127,277,0.458,45,115,0.391,82,162,0.506,0.54,63,76,0.829,53,154,207,74,20,7,55,99,362
Josh Giddey,6287400,AP,20,OKC,76,76,2367,539,1118,0.482,76,234,0.325,463,884,0.524,0.516,106,145,0.731,148,451,599,469,57,31,211,143,1260
JaMychal Green,5571403,AP,32,GSW,57,1,797,136,252,0.54,42,111,0.378,94,141,0.667,0.623,52,67,0.776,72,133,205,51,25,23,52,105,366
JaMychal Green,1836090,AP,32,GSW,57,1,797,136,252,0.54,42,111,0.378,94,141,0.667,0.623,52,67,0.776,72,133,205,51,25,23,52,105,366
Ousmane Dieng,4569840,AP,19,OKC,39,1,569,76,181,0.42,26,98,0.265,50,83,0.602,0.492,15,23,0.652,19,86,105,46,14,7,26,42,193
Jalen Williams,4341480,ES,21,OKC,75,62,2276,414,794,0.521,73,205,0.356,341,589,0.579,0.567,155,191,0.812,84,253,337,248,103,35,123,191,1056
Aleksej Pokusevski,3261480,AP,21,OKC,34,25,701,108,249,0.434,38,104,0.365,70,145,0.483,0.51,22,35,0.629,45,114,159,64,20,43,43,58,276
Tre Mann,3046200,BA,21,OKC,67,5,1183,197,501,0.393,81,257,0.315,116,244,0.475,0.474,42,55,0.764,27,128,155,120,40,11,62,99,517
Kenrich Williams,2000000,AP,28,OKC,53,10,1206,179,346,0.517,50,134,0.373,129,212,0.608,0.59,17,39,0.436,97,164,261,105,45,14,32,112,425
Jaylin Williams,2000000,P,20,OKC,49,36,914,102,234,0.436,46,113,0.407,56,121,0.463,0.534,38,54,0.704,44,197,241,76,28,12,37,111,288
Jeremiah Robinson-Earl,2000000,AP,22,OKC,43,20,814,110,248,0.444,37,111,0.333,73,137,0.533,0.518,35,42,0.833,71,109,180,43,24,11,19,71,292
Isaiah Joe,1836090,ES,23,OKC,73,10,1395,224,508,0.441,161,394,0.409,63,114,0.553,0.599,82,100,0.82,27,148,175,88,48,8,39,105,691
Justin Jackson,1836090,AL,27,BOS,23,0,107,7,27,0.259,5,20,0.25,2,7,0.286,0.352,1,2,0.5,2,15,17,9,4,4,2,7,20
Aaron Wiggins,1563518,ES,24,OKC,70,14,1297,186,363,0.512,48,122,0.393,138,241,0.573,0.579,59,71,0.831,68,142,210,80,39,15,55,110,479
Rudy Gobert,38172414,P,30,MIN,70,70,2148,360,546,0.659,0,3,0.0,360,543,0.663,0.659,219,340,0.644,231,583,814,87,56,95,122,210,939
Karl-Anthony Towns,33833400,AP,27,MIN,29,29,957,212,428,0.495,60,164,0.366,152,264,0.576,0.565,118,135,0.874,48,188,236,140,20,17,86,111,602
Mike Conley,22680000,BA,35,TOT,67,66,2029,261,610,0.428,135,351,0.385,126,259,0.486,0.539,141,169,0.834,33,149,182,450,73,14,103,139,798
Anthony Edwards,10733400,ES,21,MIN,79,79,2842,707,1541,0.459,213,578,0.369,494,963,0.513,0.528,319,422,0.756,47,411,458,350,125,58,259,186,1946
Kyle Anderson,8780488,AP,29,MIN,69,46,1957,252,495,0.509,43,105,0.41,209,390,0.536,0.553,100,136,0.735,66,302,368,335,78,63,103,146,647
Taurean Prince,7295000,AP,28,MIN,54,4,1192,177,379,0.467,74,194,0.381,103,185,0.557,0.565,65,77,0.844,15,117,132,84,28,15,69,123,493
Nickeil Alexander-Walker,5009633,ES,24,TOT,59,3,884,131,295,0.444,61,159,0.384,70,136,0.515,0.547,40,60,0.667,15,86,101,108,32,21,55,88,363
Jaden McDaniels,2161440,AL,22,MIN,79,79,2416,370,716,0.517,107,269,0.398,263,447,0.588,0.591,106,144,0.736,92,215,307,148,74,76,112,272,953
Jordan McLaughlin,2160000,BA,26,MIN,43,0,678,61,145,0.421,24,78,0.308,37,67,0.552,0.503,15,18,0.833,15,47,62,148,32,4,33,28,161
Naz Reid,1930681,P,23,MIN,68,11,1251,310,577,0.537,75,217,0.346,235,360,0.653,0.602,86,127,0.677,73,260,333,77,42,53,92,176,781
Jaylen Nowell,1930681,ES,23,MIN,65,2,1252,280,625,0.448,67,232,0.289,213,393,0.542,0.502,77,99,0.778,36,134,170,132,42,5,65,101,704
Bryn Forbes,1836090,ES,29,MIN,25,0,268,30,83,0.361,14,46,0.304,16,37,0.432,0.446,15,15,1.0,4,11,15,17,7,2,12,22,89
Austin Rivers,1836090,ES,30,MIN,52,10,1016,91,209,0.435,43,123,0.35,48,86,0.558,0.538,30,39,0.769,5,78,83,75,28,4,23,80,255
Nathan Knight,1836090,P,25,MIN,38,0,291,46,81,0.568,8,22,0.364,38,59,0.644,0.617,39,57,0.684,22,34,56,13,10,6,21,41,139
Josh Minott,1017781,AL,20,MIN,15,0,96,18,36,0.5,2,6,0.333,16,30,0.533,0.528,8,8,1.0,5,20,25,5,4,6,3,10,46
LeBron James,44474988,AP,38,LAL,55,54,1954,609,1219,0.5,121,377,0.321,488,842,0.58,0.549,251,327,0.768,65,392,457,375,50,32,178,88,1590
Anthony Davis,37980720,P,29,LAL,56,54,1904,542,962,0.563,19,74,0.257,523,888,0.589,0.573,348,444,0.784,195,507,702,148,59,114,122,146,1451
D'Angelo Russell,31377750,BA,26,TOT,71,71,2304,445,948,0.469,194,490,0.396,251,458,0.548,0.572,179,216,0.829,35,180,215,437,70,29,186,140,1263
Malik Beasley,15558035,ES,26,TOT,81,27,2093,370,937,0.395,235,658,0.357,135,279,0.484,0.52,50,65,0.769,35,248,283,124,65,9,90,107,1025
Rui Hachimura,6263188,AP,24,TOT,63,9,1466,284,584,0.486,51,160,0.319,233,424,0.55,0.53,88,119,0.739,53,230,283,58,19,26,53,72,707
Jarred Vanderbilt,4374000,AP,23,TOT,78,65,1879,247,451,0.548,29,90,0.322,218,361,0.604,0.58,96,139,0.691,170,412,582,184,83,21,97,190,619
Davon Reed,1902133,ES,27,TOT,43,1,342,28,84,0.333,17,46,0.37,11,38,0.289,0.435,16,24,0.667,10,49,59,23,15,4,20,39,89
Wenyen Gabriel,1878720,P,25,LAL,68,2,1024,155,260,0.596,10,36,0.278,145,224,0.647,0.615,52,84,0.619,116,170,286,36,26,35,46,144,372
Dennis Schröder,1836090,BA,29,LAL,66,50,1986,270,650,0.415,74,225,0.329,196,425,0.461,0.472,216,252,0.857,21,144,165,298,50,10,112,145,830
Austin Reaves,1563518,ES,24,LAL,64,22,1843,259,490,0.529,86,216,0.398,173,274,0.631,0.616,229,265,0.864,33,160,193,215,33,19,99,108,833
Max Christie,1017781,ES,19,LAL,41,3,512,44,106,0.415,26,62,0.419,18,44,0.409,0.538,14,16,0.875,7,68,75,21,9,7,13,33,128
Matt Ryan,442439,AL,25,TOT,34,0,310,40,108,0.37,32,84,0.381,8,24,0.333,0.519,10,12,0.833,4,22,26,16,5,1,7,27,122
Stephen Curry,48070014,BA,34,GSW,56,56,1941,559,1133,0.493,273,639,0.427,286,494,0.579,0.614,257,281,0.915,39,302,341,352,52,20,179,117,1648
Klay Thompson,40600080,AL,32,GSW,69,69,2279,546,1252,0.436,301,731,0.412,245,521,0.47,0.556,116,132,0.879,39,247,286,163,49,29,123,130,1509
Andrew Wiggins,33616770,AL,27,GSW,37,37,1190,250,529,0.473,89,225,0.396,161,304,0.53,0.557,44,72,0.611,61,125,186,85,45,28,48,107,633
Draymond Green,25806468,AP,32,GSW,73,73,2297,250,474,0.527,40,131,0.305,210,343,0.612,0.57,77,108,0.713,66,459,525,500,74,60,204,229,617
Kevon Looney,8000000,P,26,GSW,82,70,1958,242,384,0.63,0,1,0.0,242,383,0.632,0.63,94,155,0.606,274,486,760,207,52,50,45,225,578
Jonathan Kuminga,5739840,AP,20,GSW,67,16,1394,261,497,0.525,54,146,0.37,207,351,0.59,0.579,90,138,0.652,70,161,231,125,41,31,95,157,666
Donte DiVincenzo,4500000,ES,26,GSW,72,36,1894,235,540,0.435,150,378,0.397,85,162,0.525,0.574,58,71,0.817,80,245,325,252,97,10,112,133,678
Jordan Poole,3901399,BA,23,GSW,82,43,2458,550,1278,0.43,214,637,0.336,336,641,0.524,0.514,361,415,0.87,32,193,225,369,63,21,252,214,1675
Moses Moody,3740160,ES,20,GSW,63,3,817,108,227,0.476,49,135,0.363,59,92,0.641,0.584,37,53,0.698,28,77,105,51,18,7,34,54,302
Andre Iguodala,1836090,AP,39,GSW,8,0,113,7,15,0.467,1,9,0.111,6,6,1.0,0.5,2,3,0.667,3,14,17,19,4,3,9,11,17
Ryan Rollins,1017781,BA,20,GSW,12,0,62,7,20,0.35,3,9,0.333,4,11,0.364,0.425,6,6,1.0,3,9,12,6,1,1,16,10,23
Kawhi Leonard,42492492,AL,31,LAC,52,50,1748,446,871,0.512,104,250,0.416,342,621,0.551,0.572,243,279,0.871,57,281,338,204,72,28,88,84,1239
Paul George,42492492,AL,32,LAC,56,56,1939,459,1004,0.457,158,426,0.371,301,578,0.521,0.536,256,294,0.871,45,297,342,288,83,20,176,159,1332
Eric Gordon,19568360,ES,34,TOT,69,58,1965,291,653,0.446,132,356,0.371,159,297,0.535,0.547,142,173,0.821,16,118,134,183,43,25,104,78,856
Norman Powell,16758621,ES,29,LAC,60,8,1567,340,710,0.479,114,287,0.397,226,423,0.534,0.559,225,277,0.812,24,151,175,109,50,18,101,125,1019
Marcus Morris,16372093,AP,33,LAC,65,65,1825,274,643,0.426,112,308,0.364,162,335,0.484,0.513,68,87,0.782,29,229,258,114,42,21,56,136,728
Robert Covington,12307692,AP,32,LAC,48,0,779,102,229,0.445,54,136,0.397,48,93,0.516,0.563,30,40,0.75,31,135,166,57,38,33,32,86,288
Nicolas Batum,10843350,AP,34,LAC,78,19,1709,160,381,0.42,124,317,0.391,36,64,0.563,0.583,34,48,0.708,62,237,299,121,54,44,50,149,478
Nicolas Batum,8856969,AP,34,LAC,78,19,1709,160,381,0.42,124,317,0.391,36,64,0.563,0.583,34,48,0.708,62,237,299,121,54,44,50,149,478
Ivica Zubac,10123457,P,25,LAC,76,76,2170,326,514,0.634,0,2,0.0,326,512,0.637,0.634,166,238,0.697,236,520,756,77,29,98,117,219,818
Amir Coffey,3395062,AL,25,LAC,50,9,625,56,145,0.386,11,40,0.275,45,105,0.429,0.424,49,63,0.778,17,36,53,53,7,5,21,50,172
Bones Hyland,2201520,BA,22,TOT,56,1,1085,228,571,0.399,117,315,0.371,111,256,0.434,0.502,86,102,0.843,20,115,135,172,39,15,82,96,659
Terance Mann,1930681,ES,26,LAC,81,36,1872,272,524,0.519,77,198,0.389,195,326,0.598,0.593,92,118,0.78,77,199,276,184,42,22,80,149,713
Jason Preston,1563518,BA,23,LAC,14,0,124,18,41,0.439,5,18,0.278,13,23,0.565,0.5,0,2,0.0,2,20,22,27,2,0,10,7,41
Kevin Durant,44119845,AP,34,TOT,47,47,1672,483,862,0.56,93,230,0.404,390,632,0.617,0.614,307,334,0.919,17,296,313,235,34,67,156,99,1366
Devin Booker,33833400,ES,26,PHO,53,53,1835,527,1067,0.494,111,316,0.351,416,751,0.554,0.546,306,358,0.855,46,194,240,293,51,18,145,159,1471
Deandre Ayton,30913750,P,24,PHO,67,67,2035,522,887,0.589,7,24,0.292,515,863,0.597,0.592,152,200,0.76,172,495,667,115,37,53,120,190,1203
Chris Paul,28400000,BA,37,PHO,59,59,1889,294,668,0.44,98,261,0.375,196,407,0.482,0.513,133,160,0.831,27,224,251,524,91,22,114,126,819
Landry Shamet,9500000,ES,25,PHO,40,9,807,113,300,0.377,75,199,0.377,38,101,0.376,0.502,45,51,0.882,11,56,67,93,26,5,36,61,346
Cameron Payne,6000000,BA,28,PHO,48,15,968,188,453,0.415,68,185,0.368,120,268,0.448,0.49,49,64,0.766,12,94,106,214,33,8,81,88,493
Torrey Craig,5121951,AP,32,PHO,79,60,1948,228,500,0.456,100,253,0.395,128,247,0.518,0.556,32,45,0.711,145,281,426,117,50,62,73,179,588
Darius Bazley,4264629,P,22,TOT,43,1,616,83,183,0.454,20,53,0.377,63,130,0.485,0.508,38,70,0.543,34,104,138,38,22,34,27,44,224
T.J. Warren,1836090,AP,29,TOT,42,0,687,132,270,0.489,22,67,0.328,110,203,0.542,0.53,28,35,0.8,26,95,121,40,22,12,20,65,314
Josh Okogie,1836090,ES,24,PHO,72,26,1350,162,414,0.391,66,197,0.335,96,217,0.442,0.471,139,192,0.724,109,142,251,105,56,34,63,114,529
Damion Lee,1836090,ES,30,PHO,74,5,1506,200,452,0.442,110,247,0.445,90,205,0.439,0.564,94,104,0.904,39,186,225,99,30,7,78,118,604
Jock Landale,1563518,P,27,PHO,69,4,979,178,337,0.528,21,84,0.25,157,253,0.621,0.559,79,105,0.752,119,161,280,68,16,30,59,126,456
Terrence Ross,580373,ES,31,TOT,63,9,1330,200,465,0.43,95,258,0.368,105,207,0.507,0.532,27,34,0.794,22,132,154,95,35,10,43,97,522
Terrence Ross,10581484,ES,31,TOT,63,9,1330,200,465,0.43,95,258,0.368,105,207,0.507,0.532,27,34,0.794,22,132,154,95,35,10,43,97,522
De'Aaron Fox,30351780,BA,25,SAC,73,73,2435,682,1331,0.512,119,367,0.324,563,964,0.584,0.557,343,440,0.78,40,266,306,447,83,23,181,172,1826
Domantas Sabonis,18500000,P,26,SAC,79,79,2736,577,938,0.615,31,83,0.373,546,855,0.639,0.632,325,438,0.742,251,722,973,573,65,39,230,279,1510
Harrison Barnes,18352273,AP,30,SAC,82,82,2662,374,791,0.473,132,353,0.374,242,438,0.553,0.556,350,413,0.847,87,279,366,128,57,10,86,103,1230
Kevin Huerter,14508929,ES,24,SAC,75,75,2203,420,866,0.485,205,510,0.402,215,356,0.604,0.603,95,131,0.725,42,209,251,221,80,24,97,181,1140
Richaun Holmes,11215260,P,29,SAC,42,1,348,55,89,0.618,5,8,0.625,50,81,0.617,0.646,15,19,0.789,29,51,80,9,3,11,14,50,130
Malik Monk,9472219,ES,24,SAC,77,0,1719,357,796,0.448,143,398,0.359,214,398,0.538,0.538,184,207,0.889,32,171,203,298,49,20,146,125,1041
Keegan Murray,8008440,AL,22,SAC,80,78,2382,354,782,0.453,206,501,0.411,148,281,0.527,0.584,62,81,0.765,89,282,371,98,61,42,60,162,976
Davion Mitchell,4833600,BA,24,SAC,80,9,1447,181,399,0.454,63,197,0.32,118,202,0.584,0.533,25,31,0.806,16,89,105,185,44,15,62,112,450
Terence Davis,4000000,ES,25,SAC,64,5,841,154,364,0.423,89,243,0.366,65,121,0.537,0.545,34,43,0.791,20,119,139,67,43,12,53,104,431
Alex Len,3918600,P,29,SAC,26,2,161,16,30,0.533,0,2,0.0,16,28,0.571,0.533,11,16,0.688,24,36,60,12,4,11,16,28,43
Trey Lyles,2625000,AP,27,SAC,74,0,1247,187,408,0.458,87,240,0.363,100,168,0.595,0.565,101,124,0.815,68,232,300,66,27,31,64,97,562
Chimezie Metu,1910860,AP,25,SAC,66,0,689,129,219,0.589,9,38,0.237,120,181,0.663,0.61,54,73,0.74,47,151,198,40,22,21,32,81,321
KZ Okpala,1902133,AP,23,SAC,35,3,248,16,38,0.421,7,21,0.333,9,17,0.529,0.513,7,8,0.875,7,27,34,13,7,7,7,39,46
Matthew Dellavedova,1836090,BA,32,SAC,32,0,213,17,50,0.34,9,27,0.333,8,23,0.348,0.43,4,7,0.571,1,12,13,41,7,0,10,20,47
Kessler Edwards,1637966,AL,22,TOT,36,4,385,36,93,0.387,17,55,0.309,19,38,0.5,0.478,11,15,0.733,23,38,61,23,14,6,13,40,100
Sam Merrill,150000,ES,26,CLE,5,0,59,9,22,0.409,5,18,0.278,4,4,1.0,0.523,2,2,1.0,0,9,9,5,4,0,0,3,25
Sam Merrill,105522,ES,26,CLE,5,0,59,9,22,0.409,5,18,0.278,4,4,1.0,0.523,2,2,1.0,0,9,9,5,4,0,0,3,25
Steven Adams,17926829,P,29,MEM,42,42,1133,157,263,0.597,0,1,0.0,157,262,0.599,0.597,47,129,0.364,214,271,485,97,36,46,79,98,361
Tyus Jones,15000000,BA,26,MEM,80,22,1940,311,710,0.438,121,326,0.371,190,384,0.495,0.523,80,100,0.8,28,172,200,417,83,6,74,32,823
Luke Kennard,14415545,ES,26,TOT,59,14,1315,188,382,0.492,133,269,0.494,55,113,0.487,0.666,37,39,0.949,15,143,158,91,32,5,46,82,546
Ja Morant,12119440,BA,23,MEM,61,59,1948,566,1214,0.466,92,300,0.307,474,914,0.519,0.504,372,497,0.748,61,296,357,493,66,16,206,100,1596
Dillon Brooks,11400000,AL,27,MEM,73,73,2214,392,991,0.396,143,439,0.326,249,552,0.451,0.468,120,154,0.779,45,199,244,189,65,16,104,240,1047
Ziaire Williams,4591680,AL,21,MEM,37,4,561,84,196,0.429,25,97,0.258,59,99,0.596,0.492,17,22,0.773,16,63,79,35,14,6,37,58,210
Brandon Clarke,4343920,AP,26,MEM,56,8,1090,229,349,0.656,1,6,0.167,228,343,0.665,0.658,99,137,0.723,92,218,310,72,34,37,55,131,558
Jake LaRavia,3047640,AP,21,MEM,35,0,414,37,95,0.389,24,71,0.338,13,24,0.542,0.516,7,9,0.778,19,44,63,21,12,4,18,49,105
David Roddy,2588640,AP,21,MEM,70,4,1258,180,420,0.429,65,212,0.307,115,208,0.553,0.506,41,65,0.631,50,143,193,59,29,19,57,107,466
John Konchar,2300000,AL,26,MEM,72,23,1494,138,320,0.431,60,177,0.339,78,143,0.545,0.525,28,36,0.778,64,246,310,100,77,25,37,112,364
Desmond Bane,2130240,ES,24,MEM,58,58,1841,450,939,0.479,166,407,0.408,284,532,0.534,0.568,181,205,0.883,43,248,291,254,56,22,126,150,1247
Santi Aldama,2094120,AP,22,MEM,77,20,1682,247,525,0.47,94,266,0.353,153,259,0.591,0.56,108,144,0.75,85,286,371,97,45,48,60,143,696
Kennedy Chandler,1200000,BA,20,MEM,36,0,281,35,83,0.422,2,15,0.133,33,68,0.485,0.434,6,13,0.462,9,29,38,58,12,5,18,15,78
Nikola Jokić,33047803,P,27,DEN,69,69,2323,646,1022,0.632,57,149,0.383,589,873,0.675,0.66,341,415,0.822,167,650,817,678,87,47,247,174,1690
Jamal Murray,31650600,BA,25,DEN,65,65,2133,473,1041,0.454,172,432,0.398,301,609,0.494,0.537,180,216,0.833,48,209,257,400,66,16,145,103,1298
Aaron Gordon,19690909,AP,27,DEN,68,68,2055,429,761,0.564,60,173,0.347,369,588,0.628,0.603,191,314,0.608,164,282,446,203,54,51,98,129,1109
Kentavious Caldwell-Pope,14004703,ES,29,DEN,76,76,2381,292,632,0.462,135,319,0.423,157,313,0.502,0.569,103,125,0.824,35,173,208,183,112,35,86,145,822
Bruce Brown,6479000,AL,26,DEN,80,31,2280,358,741,0.483,91,254,0.358,267,487,0.548,0.545,116,153,0.758,63,265,328,268,87,51,123,190,923
Ish Smith,4725000,BA,34,DEN,43,0,398,52,131,0.397,2,12,0.167,50,119,0.42,0.405,2,4,0.5,5,49,54,100,8,7,44,33,108
Jeff Green,4500000,AP,36,DEN,56,4,1091,160,328,0.488,30,104,0.288,130,224,0.58,0.534,87,117,0.744,38,106,144,69,18,17,46,99,437
Christian Braun,2808600,ES,21,DEN,76,6,1181,143,289,0.495,34,96,0.354,109,193,0.565,0.554,40,64,0.625,48,133,181,59,41,17,35,101,360
Zeke Nnaji,2617800,AP,22,DEN,53,5,728,110,196,0.561,17,65,0.262,93,131,0.71,0.605,40,62,0.645,65,73,138,18,17,23,31,105,277
Vlatko Čančar,2234359,AP,25,DEN,60,9,889,108,227,0.476,43,115,0.374,65,112,0.58,0.57,38,41,0.927,24,104,128,80,22,14,37,84,297
Peyton Watson,2193960,ES,20,DEN,23,2,186,29,59,0.492,6,14,0.429,23,45,0.511,0.542,11,20,0.55,8,29,37,11,2,11,8,14,75
Thomas Bryant,1836090,P,25,TOT,59,26,1081,230,369,0.623,26,59,0.441,204,310,0.658,0.659,93,126,0.738,86,253,339,31,16,30,38,102,579
DeAndre Jordan,1836090,P,34,DEN,39,8,586,88,115,0.765,1,1,1.0,87,114,0.763,0.77,22,48,0.458,52,150,202,34,12,23,48,71,199
DeAndre Jordan,7827907,P,34,DEN,39,8,586,88,115,0.765,1,1,1.0,87,114,0.763,0.77,22,48,0.458,52,150,202,34,12,23,48,71,199
Reggie Jackson,580373,BA,32,TOT,68,40,1657,263,640,0.411,96,288,0.333,167,352,0.474,0.486,71,78,0.91,25,119,144,233,47,6,115,114,693
Reggie Jackson,10876844,BA,32,TOT,68,40,1657,263,640,0.411,96,288,0.333,167,352,0.474,0.486,71,78,0.91,25,119,144,233,47,6,115,114,693
Bojan Bogdanović,19550000,AP,33,DET,59,59,1893,430,882,0.488,145,353,0.411,285,529,0.539,0.57,268,303,0.884,36,187,223,152,34,8,135,113,1273
Cade Cunningham,10552800,BA,21,DET,12,12,400,93,224,0.415,17,61,0.279,76,163,0.466,0.453,36,43,0.837,12,62,74,72,10,7,39,34,239
Alec Burks,10012800,ES,31,DET,51,8,1122,200,459,0.436,99,239,0.414,101,220,0.459,0.544,153,188,0.814,19,139,158,114,38,8,58,98,652
James Wiseman,9603360,P,21,TOT,45,22,867,189,339,0.558,4,20,0.2,185,319,0.58,0.563,68,97,0.701,73,194,267,30,7,27,51,108,450
Nerlens Noel,9240000,P,28,TOT,17,4,195,13,36,0.361,1,2,0.5,12,34,0.353,0.375,8,12,0.667,10,36,46,10,16,10,13,32,35
Nerlens Noel,105522,P,28,TOT,17,4,195,13,36,0.361,1,2,0.5,12,34,0.353,0.375,8,12,0.667,10,36,46,10,16,10,13,32,35
Jaden Ivey,7252200,ES,20,DET,74,73,2304,409,983,0.416,120,350,0.343,289,633,0.457,0.477,266,356,0.747,73,215,288,387,61,17,237,242,1204
Killian Hayes,5837760,BA,21,DET,76,56,2154,307,815,0.377,80,286,0.28,227,529,0.429,0.426,92,112,0.821,28,193,221,470,104,28,173,219,786
Hamidou Diallo,5200000,AL,24,DET,56,0,996,215,375,0.573,5,21,0.238,210,354,0.593,0.58,87,148,0.588,57,137,194,55,53,16,71,124,522
Cory Joseph,5155500,BA,31,DET,62,2,1227,150,351,0.427,70,180,0.389,80,171,0.468,0.527,57,72,0.792,21,85,106,217,34,9,56,88,427
Jalen Duren,4124280,P,19,DET,67,31,1670,258,398,0.648,0,2,0.0,258,396,0.652,0.648,96,157,0.611,229,366,595,75,44,59,92,182,612
Isaiah Stewart,3433320,P,21,DET,50,47,1414,195,441,0.442,67,205,0.327,128,236,0.542,0.518,110,149,0.738,115,288,403,70,20,34,68,133,567
Rodney McGruder,1836090,ES,31,DET,32,12,524,62,152,0.408,41,97,0.423,21,55,0.382,0.543,18,22,0.818,20,54,74,28,16,1,11,39,183
Isaiah Livers,1563518,AP,24,DET,52,22,1199,120,288,0.417,74,203,0.365,46,85,0.541,0.545,32,39,0.821,28,115,143,41,28,28,30,103,346
R.J. Hampton,485403,ES,21,TOT,47,3,750,102,237,0.43,41,116,0.353,61,121,0.504,0.517,57,76,0.75,18,69,87,54,27,9,42,51,302
R.J. Hampton,2412840,ES,21,TOT,47,3,750,102,237,0.43,41,116,0.353,61,121,0.504,0.517,57,76,0.75,18,69,87,54,27,9,42,51,302
Eugene Omoruyi,94136,AL,25,TOT,40,6,645,101,228,0.443,25,89,0.281,76,139,0.547,0.498,51,75,0.68,43,68,111,28,28,3,34,91,278
Gordon Hayward,30075000,AL,32,CHO,50,50,1577,276,581,0.475,52,160,0.325,224,421,0.532,0.52,129,159,0.811,33,182,215,206,42,12,99,70,733
Terry Rozier,21486316,ES,28,CHO,63,63,2221,493,1188,0.415,165,505,0.327,328,683,0.48,0.484,178,220,0.809,51,208,259,319,74,16,134,119,1329
LaMelo Ball,8623920,BA,21,CHO,36,36,1268,296,721,0.411,144,383,0.376,152,338,0.45,0.51,102,122,0.836,42,189,231,304,46,11,129,118,838
Cody Martin,7000000,AL,27,CHO,7,0,134,14,36,0.389,3,14,0.214,11,22,0.5,0.431,4,7,0.571,8,16,24,11,4,1,2,13,35
P.J. Washington,5808435,AP,24,CHO,73,73,2380,434,978,0.444,149,428,0.348,285,550,0.518,0.52,127,174,0.73,73,285,358,175,66,79,110,193,1144
James Bouknight,4362240,ES,22,CHO,34,0,515,69,193,0.358,33,109,0.303,36,84,0.429,0.443,20,30,0.667,8,64,72,41,14,5,32,49,191
Kai Jones,2909040,P,22,CHO,46,0,550,67,120,0.558,4,19,0.211,63,101,0.624,0.575,19,26,0.731,37,86,123,15,17,30,31,65,157
Svi Mykhailiuk,1836090,AL,25,TOT,32,8,468,77,173,0.445,42,99,0.424,35,74,0.473,0.566,26,39,0.667,15,38,53,53,15,4,24,23,222
Svi Mykhailiuk,1878720,AL,25,TOT,32,8,468,77,173,0.445,42,99,0.424,35,74,0.473,0.566,26,39,0.667,15,38,53,53,15,4,24,23,222
Nick Richards,1782621,P,25,CHO,65,9,1217,197,313,0.629,1,1,1.0,196,312,0.628,0.631,137,183,0.749,147,269,416,38,11,71,59,154,532
JT Thor,1563518,AP,20,CHO,69,8,969,95,238,0.399,39,123,0.317,56,115,0.487,0.481,33,47,0.702,36,116,152,36,22,23,44,66,262
Jonathan Isaac,17400000,AP,25,ORL,11,0,124,22,53,0.415,6,15,0.4,16,38,0.421,0.472,5,9,0.556,15,29,44,6,14,4,4,5,55
Markelle Fultz,16500000,BA,24,ORL,60,60,1778,349,679,0.514,27,87,0.31,322,592,0.544,0.534,112,143,0.783,69,165,234,341,87,26,139,131,837
Gary Harris,13000000,ES,28,ORL,48,42,1184,138,307,0.45,94,218,0.431,44,89,0.494,0.603,27,30,0.9,21,77,98,59,45,12,28,93,397
Patrick Beverley,13000000,ES,34,TOT,67,67,1816,144,360,0.4,80,239,0.335,64,121,0.529,0.511,47,65,0.723,44,203,247,194,63,41,60,187,415
Patrick Beverley,506508,ES,34,TOT,67,67,1816,144,360,0.4,80,239,0.335,64,121,0.529,0.511,47,65,0.723,44,203,247,194,63,41,60,187,415
Paolo Banchero,11055120,AP,20,ORL,72,72,2430,479,1122,0.427,85,285,0.298,394,837,0.471,0.465,394,534,0.738,84,413,497,269,60,39,200,160,1437
Jalen Suggs,6922320,ES,21,ORL,53,19,1246,186,444,0.419,66,202,0.327,120,242,0.496,0.493,86,119,0.723,55,106,161,155,67,27,94,120,524
Franz Wagner,5258280,AL,21,ORL,80,80,2609,542,1118,0.485,130,360,0.361,412,758,0.544,0.543,271,322,0.842,70,259,329,283,77,17,167,183,1485
Cole Anthony,3613680,BA,22,ORL,60,4,1552,277,610,0.454,75,206,0.364,202,404,0.5,0.516,152,170,0.894,47,241,288,235,37,31,91,158,781
Chuma Okeke,3433320,AL,24,ORL,27,8,518,43,122,0.352,26,86,0.302,17,36,0.472,0.459,16,21,0.762,26,70,96,37,19,11,17,40,128
Bol Bol,2200000,AP,23,ORL,70,33,1505,261,478,0.546,30,113,0.265,231,365,0.633,0.577,82,108,0.759,69,336,405,69,30,85,112,92,634
Caleb Houstan,2000000,AL,20,ORL,51,4,812,66,182,0.363,46,136,0.338,20,46,0.435,0.489,15,18,0.833,34,65,99,30,12,7,18,63,193
Moritz Wagner,1878720,P,25,ORL,57,18,1109,198,396,0.5,51,163,0.313,147,233,0.631,0.564,153,182,0.841,69,190,259,84,37,13,68,136,600
Michael Carter-Williams,652829,BA,31,ORL,4,0,44,6,14,0.429,1,3,0.333,5,11,0.455,0.464,4,7,0.571,1,4,5,7,1,1,4,5,17
Goga Bitadze,612181,P,23,TOT,38,1,457,69,125,0.552,6,26,0.231,63,99,0.636,0.576,23,42,0.548,61,76,137,39,16,26,22,64,167
Goga Bitadze,4765339,P,23,TOT,38,1,457,69,125,0.552,6,26,0.231,63,99,0.636,0.576,23,42,0.548,61,76,137,39,16,26,22,64,167
Bradley Beal,43279250,ES,29,WAS,50,50,1673,444,878,0.506,80,219,0.365,364,659,0.552,0.551,192,228,0.842,41,155,196,271,45,33,145,107,1160
Kristaps Porziņģis,33833400,P,27,WAS,65,65,2120,507,1018,0.498,137,356,0.385,370,662,0.559,0.565,354,416,0.851,114,432,546,174,58,100,137,196,1505
Will Barton,14375000,ES,32,TOT,56,2,993,138,364,0.379,66,180,0.367,72,184,0.391,0.47,37,47,0.787,15,122,137,112,28,13,48,56,379
Will Barton,432642,ES,32,TOT,56,2,993,138,364,0.379,66,180,0.367,72,184,0.391,0.47,37,47,0.787,15,122,137,112,28,13,48,56,379
Kyle Kuzma,13000000,AP,27,WAS,64,64,2239,512,1142,0.448,160,481,0.333,352,661,0.533,0.518,173,237,0.73,55,408,463,239,36,29,190,145,1357
Monte Morris,9125000,BA,27,WAS,62,61,1695,247,515,0.48,78,204,0.382,169,311,0.543,0.555,64,77,0.831,26,184,210,326,43,13,60,75,636
Delon Wright,7804878,BA,30,WAS,50,14,1221,138,291,0.474,41,119,0.345,97,172,0.564,0.545,52,60,0.867,58,122,180,194,92,17,44,59,369
Kendrick Nunn,5250000,ES,27,TOT,70,2,964,191,450,0.424,79,223,0.354,112,227,0.493,0.512,35,41,0.854,15,94,109,90,28,7,66,66,496
Deni Avdija,4916160,AL,22,WAS,76,40,2020,253,579,0.437,69,232,0.297,184,347,0.53,0.497,122,165,0.739,74,413,487,211,65,29,123,209,697
Johnny Davis,4810320,ES,20,WAS,28,5,423,66,171,0.386,17,70,0.243,49,101,0.485,0.436,14,27,0.519,10,55,65,28,10,8,17,48,163
Corey Kispert,3552840,AL,23,WAS,74,45,2093,291,585,0.497,163,384,0.424,128,201,0.637,0.637,75,88,0.852,33,174,207,87,32,9,55,97,820
Anthony Gill,1836090,AP,30,WAS,59,8,624,71,132,0.538,4,29,0.138,67,103,0.65,0.553,49,67,0.731,37,62,99,34,7,12,15,70,195
Taj Gibson,1836090,P,37,WAS,49,2,480,65,125,0.52,8,24,0.333,57,101,0.564,0.552,30,42,0.714,32,61,93,34,15,12,26,84,168
Isaiah Todd,1575000,AP,21,WAS,6,1,61,3,19,0.158,1,10,0.1,2,9,0.222,0.184,2,2,1.0,2,10,12,4,1,0,2,4,9
Xavier Cooks,140384,AP,27,WAS,10,1,126,17,28,0.607,0,1,0.0,17,27,0.63,0.607,4,10,0.4,16,22,38,6,6,4,8,13,38
Jamaree Bouyea,58493,BA,23,TOT,5,0,71,6,14,0.429,2,6,0.333,4,8,0.5,0.5,1,2,0.5,1,5,6,4,4,2,4,6,15
Jamaree Bouyea,58493,BA,23,TOT,5,0,71,6,14,0.429,2,6,0.333,4,8,0.5,0.5,1,2,0.5,1,5,6,4,4,2,4,6,15
Myles Turner,35069500,P,26,IND,62,62,1825,402,733,0.548,93,249,0.373,309,484,0.638,0.612,216,276,0.783,88,378,466,89,36,140,103,215,1113
Buddy Hield,21177750,AL,30,IND,80,73,2482,475,1038,0.458,288,677,0.425,187,361,0.518,0.596,106,129,0.822,67,333,400,225,92,26,139,156,1344
Daniel Theis,8694369,P,30,IND,7,1,109,21,44,0.477,2,11,0.182,19,33,0.576,0.5,5,12,0.417,7,15,22,9,2,6,3,7,49
T.J. McConnell,8100000,BA,30,IND,75,6,1526,283,521,0.543,26,59,0.441,257,462,0.556,0.568,58,68,0.853,45,189,234,397,81,10,143,105,650
Bennedict Mathurin,6586800,ES,20,IND,78,17,2222,413,951,0.434,100,310,0.323,313,641,0.488,0.487,376,454,0.828,87,231,318,116,48,13,152,162,1302
Jalen Smith,4670160,P,22,IND,68,31,1279,242,508,0.476,54,191,0.283,188,317,0.593,0.53,104,137,0.759,129,265,394,66,21,60,72,153,642
Tyrese Haliburton,4215120,BA,22,IND,56,56,1883,412,841,0.49,161,402,0.4,251,439,0.572,0.586,175,201,0.871,33,172,205,585,91,25,141,69,1160
George Hill,4000000,BA,36,TOT,46,1,834,78,166,0.47,34,95,0.358,44,71,0.62,0.572,42,55,0.764,15,70,85,110,26,6,34,55,232
Chris Duarte,3936960,AL,25,IND,46,12,897,123,333,0.369,55,174,0.316,68,159,0.428,0.452,61,72,0.847,19,96,115,64,25,9,41,65,362
Aaron Nesmith,3804360,AL,23,IND,73,60,1816,252,590,0.427,115,314,0.366,137,276,0.496,0.525,119,142,0.838,62,215,277,98,55,34,75,235,738
Jordan Nwora,2800000,AL,24,TOT,62,14,1188,194,445,0.436,86,211,0.408,108,234,0.462,0.533,68,86,0.791,51,178,229,88,24,14,66,74,542
Isaiah Jackson,2573760,P,21,IND,63,12,1042,179,318,0.563,2,14,0.143,177,304,0.582,0.566,95,146,0.651,113,169,282,51,31,93,51,154,455
Andrew Nembhard,2244111,ES,23,IND,75,63,2073,284,644,0.441,92,263,0.35,192,381,0.504,0.512,49,62,0.79,35,164,199,341,70,13,126,179,709
Oshae Brissett,1846738,AP,24,IND,65,2,1083,123,319,0.386,48,155,0.31,75,164,0.457,0.461,104,145,0.717,62,156,218,44,33,13,34,79,398
Serge Ibaka,1836090,P,33,MIL,16,0,185,26,54,0.481,6,18,0.333,20,36,0.556,0.537,8,13,0.615,15,29,44,4,2,7,11,23,66
James Johnson,590926,AP,35,IND,18,1,162,22,49,0.449,3,15,0.2,19,34,0.559,0.48,4,8,0.5,4,26,30,15,7,6,8,32,51
Terry Taylor,1563518,AP,23,TOT,31,2,264,39,75,0.52,5,19,0.263,34,56,0.607,0.553,6,11,0.545,27,20,47,10,3,6,9,26,89
Zach LaVine,37096500,ES,27,CHI,77,77,2768,673,1388,0.485,204,544,0.375,469,844,0.556,0.558,363,428,0.848,42,303,345,327,69,18,194,159,1913
DeMar DeRozan,27300000,AL,33,CHI,74,74,2682,657,1303,0.504,46,142,0.324,611,1161,0.526,0.522,456,523,0.872,34,309,343,377,83,36,153,186,1816
Nikola Vučević,22000000,P,32,CHI,82,82,2746,597,1148,0.52,121,347,0.349,476,801,0.594,0.573,132,158,0.835,159,744,903,265,60,57,139,179,1447
Alex Caruso,9030000,BA,28,CHI,67,36,1575,130,286,0.455,55,151,0.364,75,135,0.556,0.551,59,73,0.808,42,154,196,193,98,46,77,159,374
Patrick Williams,7775400,AP,21,CHI,82,65,2323,314,677,0.464,115,277,0.415,199,400,0.498,0.549,90,105,0.857,78,249,327,100,72,70,101,147,833
Coby White,7413955,ES,22,CHI,74,2,1730,263,594,0.443,128,344,0.372,135,250,0.54,0.551,61,70,0.871,16,196,212,204,54,6,74,122,715
Andre Drummond,3200000,P,29,CHI,67,0,849,166,274,0.606,0,3,0.0,166,271,0.613,0.606,67,125,0.536,138,306,444,33,45,27,75,117,399
Dalen Terry,3191400,ES,20,CHI,38,0,214,32,72,0.444,7,27,0.259,25,45,0.556,0.493,14,21,0.667,12,25,37,22,11,5,8,24,85
Tony Bradley,2036318,P,25,CHI,12,0,33,6,12,0.5,3,5,0.6,3,7,0.429,0.625,4,4,1.0,1,10,11,1,1,1,1,2,19
Goran Dragić,1836090,BA,36,TOT,58,0,870,141,335,0.421,52,145,0.359,89,190,0.468,0.499,31,45,0.689,16,65,81,151,13,4,63,65,365
Goran Dragić,390433,BA,36,TOT,58,0,870,141,335,0.421,52,145,0.359,89,190,0.468,0.499,31,45,0.689,16,65,81,151,13,4,63,65,365
Javonte Green,1815677,AL,29,CHI,32,1,480,61,108,0.565,13,35,0.371,48,73,0.658,0.625,30,45,0.667,27,61,88,23,24,21,20,52,165
Marko Simonovic,1563518,P,23,CHI,7,0,20,2,7,0.286,1,4,0.25,1,3,0.333,0.357,1,2,0.5,1,1,2,0,0,0,0,5,6
Ayo Dosunmu,1563518,ES,23,CHI,80,51,2098,281,570,0.493,59,189,0.312,222,381,0.583,0.545,66,82,0.805,45,175,220,206,62,26,99,182,687
Pascal Siakam,35448672,AP,28,TOR,71,71,2652,630,1313,0.48,93,287,0.324,537,1026,0.523,0.515,367,474,0.774,131,425,556,415,65,36,169,228,1720
Fred VanVleet,21250000,BA,28,TOR,69,69,2535,437,1112,0.393,207,606,0.342,230,506,0.455,0.486,254,283,0.898,30,250,280,495,123,38,140,193,1335
OG Anunoby,17357143,AL,25,TOR,67,67,2386,421,885,0.476,142,367,0.387,279,518,0.539,0.556,140,167,0.838,95,237,332,131,128,50,132,200,1124
Chris Boucher,12690000,AP,30,TOR,76,0,1523,261,529,0.493,62,189,0.328,199,340,0.585,0.552,128,168,0.762,157,264,421,29,47,64,41,143,712
Jakob Poeltl,9398148,P,27,TOT,72,71,1906,389,618,0.629,0,1,0.0,389,617,0.63,0.629,119,201,0.592,236,417,653,197,66,86,125,195,897
Thaddeus Young,8000000,AP,34,TOR,54,9,795,108,198,0.545,6,34,0.176,102,164,0.622,0.561,18,26,0.692,71,95,166,75,54,5,42,88,240
Scottie Barnes,7644600,AL,21,TOR,77,76,2678,463,1016,0.456,63,224,0.281,400,792,0.505,0.487,190,246,0.772,179,333,512,371,83,61,154,170,1179
Precious Achiuwa,2840160,P,23,TOR,55,12,1140,196,404,0.485,29,108,0.269,167,296,0.564,0.521,87,124,0.702,100,228,328,50,31,30,59,102,508
Malachi Flynn,2145720,BA,24,TOR,53,2,691,87,242,0.36,47,133,0.353,40,109,0.367,0.457,25,33,0.758,15,61,76,70,21,4,25,65,246
Juancho Hernangómez,1836090,AP,27,TOR,42,10,614,48,114,0.421,17,67,0.254,31,47,0.66,0.496,9,16,0.563,27,96,123,25,16,6,15,43,122
Dalano Banton,1563518,BA,23,TOR,31,2,279,55,130,0.423,15,51,0.294,40,79,0.506,0.481,17,24,0.708,11,34,45,36,13,13,18,34,142
Christian Koloko,1500000,P,22,TOR,58,19,802,72,150,0.48,1,12,0.083,71,138,0.514,0.483,37,59,0.627,84,87,171,31,21,57,20,128,182
Ish Wainright,125000,AL,28,PHO,60,2,915,84,227,0.37,57,173,0.329,27,54,0.5,0.496,26,31,0.839,45,94,139,53,38,22,22,117,251
Trae Young,37096500,BA,24,ATL,73,73,2541,597,1390,0.429,154,460,0.335,443,930,0.476,0.485,566,639,0.886,56,161,217,741,80,9,300,104,1914
John Collins,23500000,AP,25,ATL,71,71,2130,359,707,0.508,70,240,0.292,289,467,0.619,0.557,143,178,0.803,77,385,462,85,42,73,79,220,931
Clint Capela,18706897,P,28,ATL,65,63,1730,350,536,0.653,0,1,0.0,350,535,0.654,0.653,79,131,0.603,258,459,717,58,45,79,54,139,779
Bogdan Bogdanović,18000000,ES,30,ATL,54,9,1508,273,611,0.447,146,360,0.406,127,251,0.506,0.566,64,77,0.831,23,142,165,150,43,18,65,86,756
Dejounte Murray,16571120,ES,26,ATL,74,74,2693,612,1319,0.464,133,387,0.344,479,932,0.514,0.514,158,190,0.832,53,336,389,448,112,19,160,106,1515
De'Andre Hunter,9835881,AL,25,ATL,67,67,2126,379,822,0.461,100,286,0.35,279,536,0.521,0.522,171,207,0.826,46,238,284,94,35,17,82,199,1029
Onyeka Okongwu,6395160,P,22,ATL,80,18,1849,317,497,0.638,4,13,0.308,313,484,0.647,0.642,153,196,0.781,217,359,576,81,56,107,81,251,791
AJ Griffin,3536160,AL,19,ATL,72,12,1401,248,533,0.465,101,259,0.39,147,274,0.536,0.56,42,47,0.894,37,116,153,73,42,12,42,87,639
Saddiq Bey,2959080,AL,23,TOT,77,37,2129,353,836,0.422,151,418,0.361,202,418,0.483,0.513,205,238,0.861,98,264,362,118,70,13,71,123,1062
Jalen Johnson,2792640,AL,21,ATL,70,6,1042,158,322,0.491,30,104,0.288,128,218,0.587,0.537,49,78,0.628,51,231,282,83,38,34,41,113,395
Bruno Fernando,2717391,P,24,TOT,39,4,405,59,112,0.527,0,4,0.0,59,108,0.546,0.527,35,50,0.7,54,83,137,31,6,34,25,74,153
Garrison Mathews,2000000,ES,26,TOT,54,0,686,73,201,0.363,63,180,0.35,10,21,0.476,0.52,48,53,0.906,11,62,73,26,24,5,19,62,257
Aaron Holiday,1836090,BA,26,ATL,63,6,845,92,220,0.418,36,88,0.409,56,132,0.424,0.5,27,32,0.844,25,49,74,89,37,12,36,79,247
Vit Krejci,1563518,BA,22,ATL,29,0,165,15,37,0.405,5,21,0.238,10,16,0.625,0.473,1,2,0.5,6,20,26,17,5,1,5,17,36
Tyrese Martin,1017781,ES,23,ATL,16,0,66,9,23,0.391,1,7,0.143,8,16,0.5,0.413,2,2,1.0,5,7,12,2,1,0,2,2,21
Jimmy Butler,37653300,AP,33,MIA,64,64,2138,479,888,0.539,36,103,0.35,443,785,0.564,0.56,472,555,0.85,141,234,375,340,117,21,101,80,1466
Bam Adebayo,30351780,P,25,MIA,75,75,2598,602,1114,0.54,1,12,0.083,601,1102,0.545,0.541,324,402,0.806,184,504,688,240,88,61,187,208,1529
Kyle Lowry,28333334,BA,36,MIA,55,44,1718,196,485,0.404,107,310,0.345,89,175,0.509,0.514,116,135,0.859,43,182,225,281,57,21,103,143,615
Duncan Robinson,16902000,AL,28,MIA,42,1,691,88,237,0.371,63,192,0.328,25,45,0.556,0.504,29,32,0.906,8,61,69,46,14,0,28,77,268
Victor Oladipo,8750000,ES,30,MIA,42,2,1106,160,403,0.397,70,212,0.33,90,191,0.471,0.484,59,79,0.747,16,112,128,146,57,12,87,99,449
Caleb Martin,6479000,AL,27,MIA,71,49,2077,254,548,0.464,84,236,0.356,170,312,0.545,0.54,91,113,0.805,88,256,344,117,71,31,78,145,683
Tyler Herro,5722116,ES,23,MIA,67,67,2337,487,1109,0.439,203,537,0.378,284,572,0.497,0.531,170,182,0.934,27,333,360,280,51,16,158,101,1347
Kevin Love,3114138,AP,34,TOT,62,20,1240,165,424,0.389,99,296,0.334,66,128,0.516,0.506,80,91,0.879,59,340,399,116,16,12,70,97,509
Kevin Love,27442830,AP,34,TOT,62,20,1240,165,424,0.389,99,296,0.334,66,128,0.516,0.506,80,91,0.879,59,340,399,116,16,12,70,97,509
Nikola Jović,2239920,AP,19,MIA,15,8,204,28,69,0.406,8,35,0.229,20,34,0.588,0.464,18,19,0.947,9,22,31,10,7,2,10,19,82
Udonis Haslem,1836090,P,42,MIA,7,1,71,10,29,0.345,3,9,0.333,7,20,0.35,0.397,4,5,0.8,4,7,11,0,1,2,1,11,27
Gabe Vincent,1815677,BA,26,MIA,68,34,1759,228,567,0.402,117,350,0.334,111,217,0.512,0.505,68,78,0.872,27,118,145,167,62,5,92,154,641
Max Strus,1815677,AL,26,MIA,80,33,2272,324,790,0.41,197,563,0.35,127,227,0.559,0.535,78,89,0.876,49,209,258,171,42,12,70,166,923
Haywood Highsmith,1752638,AP,26,MIA,54,11,969,93,216,0.431,37,109,0.339,56,107,0.523,0.516,13,28,0.464,57,131,188,43,36,17,45,82,236
Omer Yurtseven,1752638,P,24,MIA,9,0,83,16,27,0.593,3,7,0.429,13,20,0.65,0.648,5,6,0.833,8,15,23,2,2,2,4,16,40
Cody Zeller,517060,P,30,MIA,15,2,217,37,59,0.627,0,2,0.0,37,57,0.649,0.627,24,35,0.686,25,39,64,10,3,4,14,33,98
Ben Simmons,35448672,BA,26,BRK,42,33,1105,133,235,0.566,0,2,0.0,133,233,0.571,0.566,25,57,0.439,40,223,263,256,54,24,97,139,291
Mikal Bridges,20100000,ES,26,TOT,83,83,2963,593,1267,0.468,169,442,0.382,424,825,0.514,0.535,316,353,0.895,79,285,364,273,91,61,127,159,1671
Spencer Dinwiddie,19500000,ES,29,TOT,79,79,2725,460,1050,0.438,181,490,0.369,279,560,0.498,0.524,268,330,0.812,28,242,270,515,67,24,145,187,1369
Joe Harris,18642857,AL,31,BRK,74,33,1527,201,440,0.457,142,333,0.426,59,107,0.551,0.618,18,28,0.643,23,141,164,101,34,13,41,140,562
Dorian Finney-Smith,12939848,AP,29,TOT,66,66,2009,196,501,0.391,114,338,0.337,82,163,0.503,0.505,45,59,0.763,114,202,316,100,55,36,62,144,551
Royce O'Neale,9200000,AL,29,BRK,76,53,2409,229,593,0.386,163,419,0.389,66,174,0.379,0.524,50,69,0.725,55,329,384,283,65,49,114,239,671
Nic Claxton,8500000,P,23,BRK,76,76,2271,414,587,0.705,0,2,0.0,414,585,0.708,0.705,133,246,0.541,184,518,702,144,65,189,96,212,961
Seth Curry,8496653,ES,32,BRK,61,7,1211,208,449,0.463,94,232,0.405,114,217,0.525,0.568,51,55,0.927,13,87,100,99,36,7,51,96,561
Patty Mills,6479000,BA,34,BRK,40,2,567,86,209,0.411,49,134,0.366,37,75,0.493,0.529,25,30,0.833,8,36,44,56,15,3,30,32,246
Cameron Johnson,5887899,AP,26,TOT,42,41,1199,223,474,0.47,103,255,0.404,120,219,0.548,0.579,101,120,0.842,34,151,185,78,50,14,37,83,650
Jevon Carter,3925000,BA,27,MIL,81,39,1810,239,565,0.423,142,337,0.421,97,228,0.425,0.549,31,38,0.816,35,167,202,197,66,29,78,158,651
Jevon Carter,2100000,BA,27,MIL,81,39,1810,239,565,0.423,142,337,0.421,97,228,0.425,0.549,31,38,0.816,35,167,202,197,66,29,78,158,651
Cam Thomas,2138160,ES,21,BRK,57,4,948,201,456,0.441,51,133,0.383,150,323,0.464,0.497,151,174,0.868,8,87,95,78,20,7,63,55,604
Day'Ron Sharpe,2109480,P,21,BRK,48,3,552,93,171,0.544,6,11,0.545,87,160,0.544,0.561,35,55,0.636,99,101,200,37,15,32,42,89,227
Edmond Sumner,1968175,ES,27,BRK,53,12,736,124,269,0.461,31,87,0.356,93,182,0.511,0.519,99,108,0.917,13,66,79,68,31,10,50,83,378
Yuta Watanabe,1836090,AL,28,BRK,58,1,928,114,232,0.491,60,135,0.444,54,97,0.557,0.621,34,47,0.723,30,111,141,48,25,17,22,80,322
Donovan Mitchell,30913750,ES,26,CLE,68,68,2432,679,1402,0.484,245,635,0.386,434,767,0.566,0.572,319,368,0.867,63,226,289,301,99,27,180,168,1922
Jarrett Allen,20000000,P,24,CLE,68,68,2220,403,626,0.644,1,10,0.1,402,616,0.653,0.645,162,221,0.733,221,445,666,113,54,84,93,153,969
Caris LeVert,18796296,ES,28,CLE,74,30,2237,320,742,0.431,127,324,0.392,193,418,0.462,0.517,130,180,0.722,53,229,282,287,72,24,116,170,897
Darius Garland,8920795,BA,23,CLE,69,69,2447,522,1129,0.462,169,412,0.41,353,717,0.492,0.537,277,321,0.863,28,157,185,538,85,9,199,148,1490
Evan Mobley,8478720,AP,21,CLE,79,79,2715,525,947,0.554,22,102,0.216,503,845,0.595,0.566,205,304,0.674,187,524,711,224,60,119,146,218,1277
Cedi Osman,7426088,AL,27,CLE,77,2,1548,239,530,0.451,116,312,0.372,123,218,0.564,0.56,75,108,0.694,25,151,176,115,35,11,52,122,669
Isaac Okoro,7040880,AL,22,CLE,76,46,1652,175,354,0.494,62,171,0.363,113,183,0.617,0.582,78,103,0.757,52,135,187,87,56,30,42,158,490
Ricky Rubio,5853659,BA,32,CLE,33,2,566,61,178,0.343,21,82,0.256,40,96,0.417,0.402,28,35,0.8,9,61,70,115,26,6,31,51,171
Dean Wade,1930681,AP,26,CLE,44,13,891,73,177,0.412,45,127,0.354,28,50,0.56,0.54,15,23,0.652,20,130,150,37,28,21,17,89,206
Raul Neto,1836090,BA,30,CLE,48,1,505,57,110,0.518,12,42,0.286,45,68,0.662,0.573,31,34,0.912,10,36,46,79,17,4,24,49,157
Robin Lopez,1836090,P,34,CLE,37,2,299,48,75,0.64,2,4,0.5,46,71,0.648,0.653,14,18,0.778,23,28,51,19,2,8,25,43,112
Lamar Stevens,1782621,AL,25,CLE,62,25,1120,129,288,0.448,30,95,0.316,99,193,0.513,0.5,40,57,0.702,48,159,207,33,27,19,27,79,328
Giannis Antetokounmpo,42492492,AP,28,MIL,63,63,2024,707,1278,0.553,47,171,0.275,660,1107,0.596,0.572,498,772,0.645,137,605,742,359,52,51,246,197,1959
Khris Middleton,37948276,AL,31,MIL,33,19,801,177,406,0.436,51,162,0.315,126,244,0.516,0.499,92,102,0.902,28,112,140,163,23,5,71,68,497
Jrue Holiday,33665040,BA,32,MIL,67,65,2183,490,1023,0.479,158,411,0.384,332,612,0.542,0.556,152,177,0.859,79,262,341,495,79,25,197,116,1290
Brook Lopez,13906976,P,34,MIL,78,78,2373,477,899,0.531,136,364,0.374,341,535,0.637,0.606,149,190,0.784,157,363,520,99,37,193,107,203,1239
Bobby Portis,10843350,AP,27,MIL,70,22,1818,398,803,0.496,95,257,0.37,303,546,0.555,0.555,96,125,0.768,154,518,672,105,29,16,81,115,987
Jae Crowder,10183800,AP,32,MIL,18,3,340,45,94,0.479,24,55,0.436,21,39,0.538,0.606,10,12,0.833,17,52,69,27,12,6,7,27,124
Grayson Allen,8500000,ES,27,MIL,72,70,1972,245,557,0.44,146,366,0.399,99,191,0.518,0.571,114,126,0.905,61,176,237,163,62,14,72,117,750
Joe Ingles,6479000,AL,35,MIL,46,0,1044,108,248,0.435,83,203,0.409,25,45,0.556,0.603,18,21,0.857,13,115,128,150,33,6,55,74,317
Pat Connaughton,5728393,AL,30,MIL,61,33,1443,165,421,0.392,109,322,0.339,56,99,0.566,0.521,27,41,0.659,50,233,283,77,37,11,33,69,466
MarJon Beauchamp,2485200,AL,22,MIL,52,11,701,96,243,0.395,47,142,0.331,49,101,0.485,0.492,27,37,0.73,38,77,115,35,21,7,45,71,266
Thanasis Antetokounmpo,1878720,AP,30,MIL,37,0,206,20,46,0.435,0,8,0.0,20,38,0.526,0.435,11,22,0.5,15,29,44,15,3,3,12,22,51
Wesley Matthews,1836090,AL,36,MIL,52,0,820,58,160,0.363,39,124,0.315,19,36,0.528,0.484,24,28,0.857,34,79,113,34,20,13,18,71,179
Meyers Leonard,105522,P,30,MIL,9,2,114,14,29,0.483,7,18,0.389,7,11,0.636,0.603,8,9,0.889,12,22,34,1,2,0,6,16,43
Jalen Brunson,27733332,BA,26,NYK,68,68,2379,587,1195,0.491,134,322,0.416,453,873,0.519,0.547,325,392,0.829,40,201,241,421,61,15,142,152,1633
Julius Randle,23760000,AP,28,NYK,77,77,2737,658,1432,0.459,218,636,0.343,440,796,0.553,0.536,402,531,0.757,141,626,767,316,49,21,216,233,1936
Evan Fournier,18000000,ES,30,NYK,27,7,459,56,166,0.337,35,114,0.307,21,52,0.404,0.443,18,21,0.857,4,45,49,36,16,3,22,46,165
Derrick Rose,14520730,BA,34,NYK,27,0,338,61,159,0.384,19,63,0.302,42,96,0.438,0.443,11,12,0.917,8,32,40,46,7,5,22,18,152
Josh Hart,12960000,AL,27,TOT,76,52,2454,275,520,0.529,61,164,0.372,214,356,0.601,0.588,132,176,0.75,142,451,593,290,88,21,117,195,743
RJ Barrett,10900635,ES,22,NYK,73,73,2475,510,1176,0.434,121,390,0.31,389,786,0.495,0.485,290,392,0.74,60,308,368,201,31,15,164,179,1431
Isaiah Hartenstein,7804879,P,24,NYK,82,8,1626,175,327,0.535,8,37,0.216,167,290,0.576,0.547,48,71,0.676,209,327,536,102,53,64,66,213,406
Obi Toppin,5348280,AP,24,NYK,67,5,1050,187,419,0.446,85,247,0.344,102,172,0.593,0.548,38,47,0.809,29,158,187,66,23,12,38,68,497
Immanuel Quickley,2316240,ES,23,NYK,81,21,2344,419,936,0.448,168,454,0.37,251,482,0.521,0.537,203,248,0.819,58,279,337,279,80,14,100,166,1209
Quentin Grimes,2277000,ES,22,NYK,71,66,2121,282,602,0.468,157,407,0.386,125,195,0.641,0.599,78,98,0.796,49,180,229,150,47,26,69,177,799
Jericho Sims,1639842,P,24,NYK,52,16,812,83,107,0.776,0,1,0.0,83,106,0.783,0.776,12,16,0.75,99,143,242,25,15,28,27,96,178
Miles McBride,1563518,BA,22,NYK,64,2,760,77,215,0.358,40,134,0.299,37,81,0.457,0.451,28,42,0.667,13,37,50,72,37,8,25,60,222
Tobias Harris,37633050,AL,30,PHI,74,74,2436,423,845,0.501,126,324,0.389,297,521,0.57,0.575,113,129,0.876,67,357,424,186,68,40,89,149,1085
Joel Embiid,33616770,P,28,PHI,66,66,2284,728,1328,0.548,66,200,0.33,662,1128,0.587,0.573,661,771,0.857,113,557,670,274,66,112,226,205,2183
James Harden,33000000,BA,33,PHI,58,58,2135,371,842,0.441,161,418,0.385,210,424,0.495,0.536,313,361,0.867,40,314,354,618,71,31,195,112,1216
P.J. Tucker,10490000,AP,37,PHI,75,75,1920,96,225,0.427,55,140,0.393,41,85,0.482,0.549,19,23,0.826,95,200,295,60,39,15,44,180,266
De'Anthony Melton,8250000,ES,24,PHI,77,58,2150,277,651,0.425,157,403,0.39,120,248,0.484,0.546,69,87,0.793,69,243,312,197,126,41,102,191,780
Furkan Korkmaz,5000000,ES,25,PHI,37,0,353,48,111,0.432,18,46,0.391,30,65,0.462,0.514,26,36,0.722,6,36,42,22,10,3,24,18,140
Georges Niang,3465000,AP,29,PHI,78,1,1512,222,502,0.442,154,384,0.401,68,118,0.576,0.596,39,45,0.867,19,166,185,77,30,14,54,145,637
Tyrese Maxey,2726880,ES,22,PHI,60,41,2016,439,913,0.481,160,369,0.434,279,544,0.513,0.568,180,213,0.845,23,153,176,212,49,8,80,132,1218
Montrezl Harrell,2463490,P,29,PHI,57,7,681,125,209,0.598,0,6,0.0,125,203,0.616,0.598,70,101,0.693,67,92,159,33,17,25,35,75,320
Jaden Springer,2125200,ES,20,PHI,16,2,89,17,35,0.486,2,5,0.4,15,30,0.5,0.514,6,8,0.75,6,8,14,8,7,3,3,15,42
Shake Milton,1997718,ES,26,PHI,76,11,1567,241,503,0.479,56,148,0.378,185,355,0.521,0.535,99,116,0.853,39,152,191,240,25,13,94,123,637
Jalen McDaniels,1930681,AL,25,TOT,80,24,1913,281,617,0.455,77,232,0.332,204,385,0.53,0.518,116,138,0.841,63,283,346,130,83,34,93,209,755
Paul Reed,1782621,P,23,PHI,69,2,755,124,209,0.593,1,6,0.167,123,203,0.606,0.596,38,51,0.745,112,150,262,27,46,51,45,123,287
Trevelin Queen,330000,ES,25,IND,7,0,70,7,29,0.241,2,15,0.133,5,14,0.357,0.276,5,5,1.0,8,9,17,6,2,5,7,4,21
Charles Bassey,74742,P,22,SAS,35,2,508,87,135,0.644,3,8,0.375,84,127,0.661,0.656,22,37,0.595,75,118,193,47,16,33,41,74,199
Jayson Tatum,30351780,AL,24,BOS,74,74,2732,727,1559,0.466,240,686,0.35,487,873,0.558,0.543,531,622,0.854,78,571,649,342,78,51,213,160,2225
Jaylen Brown,28741071,AL,26,BOS,67,67,2405,679,1383,0.491,163,487,0.335,516,896,0.576,0.55,263,344,0.765,78,381,459,232,75,26,197,172,1784
Al Horford,26500000,P,36,BOS,63,63,1922,228,479,0.476,145,325,0.446,83,154,0.539,0.627,15,21,0.714,73,317,390,189,30,61,37,121,616
Malcolm Brogdon,22600000,BA,30,BOS,67,0,1744,354,732,0.484,132,297,0.444,222,435,0.51,0.574,160,184,0.87,42,238,280,248,45,18,98,109,1000
Marcus Smart,17457142,BA,28,BOS,61,61,1957,250,602,0.415,115,342,0.336,135,260,0.519,0.511,88,118,0.746,46,145,191,382,93,23,143,172,703
Derrick White,16892857,ES,28,BOS,82,70,2319,350,758,0.462,149,391,0.381,201,367,0.548,0.56,168,192,0.875,52,241,293,321,54,76,95,177,1017
Robert Williams,10937502,P,25,BOS,35,20,824,127,170,0.747,0,1,0.0,127,169,0.751,0.747,25,41,0.61,104,188,292,50,22,48,34,68,279
Grant Williams,4306281,AP,24,BOS,79,23,2045,216,476,0.454,115,291,0.395,101,185,0.546,0.575,94,122,0.77,87,276,363,131,41,31,82,192,641
Mike Muscala,3500000,P,31,TOT,63,9,945,131,292,0.449,81,207,0.391,50,85,0.588,0.587,40,52,0.769,37,166,203,50,15,24,23,98,383
Payton Pritchard,2239200,BA,25,BOS,48,3,643,101,245,0.412,56,154,0.364,45,91,0.495,0.527,12,16,0.75,25,63,88,64,14,1,40,37,270
Luke Kornet,2133278,P,27,BOS,69,0,804,113,170,0.665,3,13,0.231,110,157,0.701,0.674,32,39,0.821,86,111,197,53,11,46,25,81,261
Blake Griffin,1836090,P,33,BOS,41,16,569,63,130,0.485,23,66,0.348,40,64,0.625,0.573,21,32,0.656,47,108,155,61,14,9,22,75,170
Sam Hauser,1637966,AL,25,BOS,80,8,1290,180,396,0.455,140,335,0.418,40,61,0.656,0.631,12,17,0.706,35,169,204,71,29,21,30,99,512
Precious Achiuwa,4379527,P,24,TOT,56,17,1276,195,391,0.499,23,85,0.271,172,306,0.562,0.528,55,89,0.618,150,223,373,78,38,52,63,107,468
Bam Adebayo,32600060,P,26,MIA,53,53,1835,403,793,0.508,1,14,0.071,402,779,0.516,0.509,250,325,0.769,117,429,546,214,57,51,130,128,1057
Ochai Agbaji,4114200,ES,23,TOT,63,14,1208,132,323,0.409,56,177,0.316,76,146,0.521,0.495,24,32,0.75,46,109,155,57,32,33,44,83,344
Santi Aldama,2194200,AP,23,MEM,52,26,1334,210,485,0.433,89,255,0.349,121,230,0.526,0.525,42,69,0.609,62,228,290,115,34,41,63,75,551
Grayson Allen,8500000,ES,28,PHO,58,58,1949,250,505,0.495,154,328,0.47,96,177,0.542,0.648,100,113,0.885,36,191,227,179,50,37,75,127,754
Jarrett Allen,20000000,P,25,CLE,58,58,1836,381,608,0.627,0,5,0.0,381,603,0.632,0.627,178,243,0.733,198,426,624,159,44,67,97,120,940
Jose Alvarado,1836096,BA,25,NOP,42,0,723,106,258,0.411,52,148,0.351,54,110,0.491,0.512,29,42,0.69,16,75,91,86,48,14,33,62,293
Kyle Anderson,9219512,AP,30,MIN,62,6,1382,151,323,0.467,8,37,0.216,143,286,0.5,0.48,77,109,0.706,45,172,217,253,50,32,77,96,387
Cole Anthony,5539771,BA,23,ORL,63,0,1448,256,594,0.431,65,206,0.316,191,388,0.492,0.486,157,190,0.826,52,200,252,194,53,29,106,154,734
OG Anunoby,18642857,AL,26,TOT,41,41,1400,238,478,0.498,86,227,0.379,152,251,0.606,0.588,65,84,0.774,39,132,171,93,53,28,62,96,627
Deni Avdija,6263188,AL,23,WAS,60,60,1723,306,606,0.505,70,175,0.4,236,431,0.548,0.563,143,193,0.741,68,342,410,223,48,26,121,150,825
Deandre Ayton,32459438,P,25,POR,41,41,1303,279,490,0.569,0,1,0.0,279,489,0.571,0.569,44,53,0.83,126,316,442,70,44,32,72,90,602
Marvin Bagley III,12500000,P,24,TOT,44,22,932,207,360,0.575,5,17,0.294,202,343,0.589,0.582,89,119,0.748,119,153,272,54,17,28,53,77,508
Patrick Baldwin Jr.,2337720,AL,21,WAS,20,0,152,18,47,0.383,11,27,0.407,7,20,0.35,0.5,8,12,0.667,7,36,43,8,2,4,6,22,55
LaMelo Ball,10900635,BA,22,CHO,22,22,711,183,423,0.433,70,197,0.355,113,226,0.5,0.515,90,104,0.865,29,84,113,176,40,4,83,79,526
Mo Bamba,2346614,P,25,PHI,41,4,457,62,132,0.47,14,34,0.412,48,98,0.49,0.523,21,33,0.636,57,100,157,28,13,40,30,64,159
Paolo Banchero,11608080,AP,21,ORL,62,62,2161,508,1099,0.462,94,257,0.366,414,842,0.492,0.505,310,439,0.706,69,356,425,322,61,36,192,123,1420
Desmond Bane,3845083,ES,25,MEM,37,37,1277,330,696,0.474,123,320,0.384,207,376,0.551,0.563,121,140,0.864,34,135,169,196,38,20,99,106,904
Dalano Banton,2019706,BA,24,TOT,36,5,449,80,193,0.415,21,67,0.313,59,126,0.468,0.469,43,61,0.705,28,61,89,50,11,9,27,38,224
Dominick Barlow,877065,AP,20,SAS,26,1,350,49,97,0.505,3,8,0.375,46,89,0.517,0.521,27,40,0.675,38,55,93,30,11,13,5,40,128
Harrison Barnes,17000000,AP,31,SAC,62,62,1815,263,537,0.49,115,291,0.395,148,246,0.602,0.597,115,142,0.81,49,126,175,70,43,10,43,78,756
Scottie Barnes,8008560,ES,22,TOR,60,60,2094,447,942,0.475,101,296,0.341,346,646,0.536,0.528,196,251,0.781,141,353,494,363,75,88,165,118,1191
RJ Barrett,23883929,ES,23,TOT,52,52,1637,375,768,0.488,85,230,0.37,290,538,0.539,0.544,175,249,0.703,44,228,272,162,28,20,103,113,1010
Charles Bassey,2500000,P,23,SAS,19,0,205,29,40,0.725,0,1,0.0,29,39,0.744,0.725,5,6,0.833,23,53,76,21,8,17,15,31,63
Keita Bates-Diop,2346614,AL,28,TOT,48,8,648,72,165,0.436,21,69,0.304,51,96,0.531,0.5,30,40,0.75,31,76,107,37,24,22,15,34,195
Nicolas Batum,11710818,AP,35,TOT,42,30,1022,82,171,0.48,51,121,0.421,31,50,0.62,0.629,14,19,0.737,52,114,166,90,29,30,26,84,229
Bradley Beal,46741590,ES,30,PHO,35,35,1141,251,506,0.496,59,155,0.381,192,351,0.547,0.554,84,107,0.785,30,113,143,161,33,10,87,90,645
Malik Beasley,2709849,ES,27,MIL,62,62,1836,253,553,0.458,179,411,0.436,74,142,0.521,0.619,17,27,0.63,39,200,239,88,53,7,43,129,702
MarJon Beauchamp,2609400,AL,23,MIL,45,1,589,74,155,0.477,28,71,0.394,46,84,0.548,0.568,19,28,0.679,22,74,96,30,12,6,27,52,195
Patrick Beverley,3196448,BA,35,TOT,59,6,1137,127,304,0.418,47,142,0.331,80,162,0.494,0.495,59,73,0.808,40,144,184,169,34,24,59,102,360
Saddiq Bey,4556983,AL,24,ATL,62,50,2035,287,686,0.418,110,350,0.314,177,336,0.527,0.499,165,197,0.838,166,240,406,90,51,11,54,87,849
Goga Bitadze,2066585,P,24,ORL,52,33,906,117,193,0.606,2,12,0.167,115,181,0.635,0.611,52,79,0.658,103,167,270,75,30,70,40,102,288
Onuralp Bitim,895708,ES,24,CHI,8,0,96,9,24,0.375,8,18,0.444,1,6,0.167,0.542,3,4,0.75,2,10,12,3,2,1,3,6,29
Anthony Black,7245480,BA,20,ORL,58,33,1077,104,224,0.464,34,85,0.4,70,139,0.504,0.54,48,75,0.64,31,102,133,86,32,18,51,104,290
Bol Bol,2165000,AP,24,PHO,26,0,291,65,104,0.625,10,30,0.333,55,74,0.743,0.673,7,10,0.7,25,67,92,11,6,16,11,30,147
Devin Booker,36016200,BA,27,PHO,50,50,1788,480,971,0.494,110,290,0.379,370,681,0.543,0.551,307,349,0.88,35,194,229,342,47,20,129,151,1377
Chris Boucher,11750000,AP,31,TOR,50,0,705,110,217,0.507,31,94,0.33,79,123,0.642,0.578,71,92,0.772,62,145,207,23,14,24,28,68,322
James Bouknight,4570080,ES,23,CHO,14,0,81,18,41,0.439,13,30,0.433,5,11,0.455,0.598,1,2,0.5,1,8,9,6,1,1,2,3,50
Malaki Branham,3071880,BA,20,SAS,59,23,1228,211,480,0.44,70,196,0.357,141,284,0.496,0.513,45,48,0.938,21,97,118,132,23,6,70,74,537
Christian Braun,2949120,ES,22,DEN,64,1,1225,161,359,0.448,42,117,0.359,119,242,0.492,0.507,77,109,0.706,55,175,230,87,29,28,41,106,441
Mikal Bridges,21700000,AL,27,BRK,64,64,2265,470,1066,0.441,163,455,0.358,307,611,0.502,0.517,232,286,0.811,52,251,303,239,62,25,135,96,1335
Miles Bridges,7921300,AL,25,CHO,53,51,1985,435,943,0.461,126,349,0.361,309,594,0.52,0.528,135,161,0.839,52,348,400,174,55,27,107,98,1131
Oshae Brissett,2165000,AL,25,BOS,40,0,427,50,110,0.455,12,43,0.279,38,67,0.567,0.509,36,55,0.655,37,73,110,31,16,4,13,39,148
Malcolm Brogdon,22500000,BA,31,POR,39,25,1121,218,496,0.44,82,199,0.412,136,297,0.458,0.522,95,116,0.819,28,120,148,214,27,8,60,58,613
Armoni Brooks,241285,BA,25,BRK,10,0,104,15,46,0.326,11,32,0.344,4,14,0.286,0.446,1,2,0.5,7,11,18,5,1,1,3,3,42
Dillon Brooks,22627671,AL,28,HOU,54,54,1692,251,579,0.434,102,270,0.378,149,309,0.482,0.522,97,117,0.829,43,149,192,90,49,7,67,181,701
Bruce Brown,21951220,ES,27,TOT,52,38,1463,212,458,0.463,42,138,0.304,170,320,0.531,0.509,95,110,0.864,43,188,231,142,48,16,59,118,561
Jaylen Brown,31830357,AL,27,BOS,58,58,1938,513,1024,0.501,119,336,0.354,394,688,0.573,0.559,179,254,0.705,67,255,322,215,63,29,136,154,1324
Kobe Brown,2413320,AP,24,LAC,34,0,285,24,63,0.381,12,39,0.308,12,24,0.5,0.476,1,2,0.5,10,35,45,17,6,3,7,41,61
Jalen Brunson,26346666,BA,27,NYK,58,58,2048,561,1173,0.478,154,376,0.41,407,797,0.511,0.544,301,356,0.846,32,181,213,376,53,11,143,116,1577
Thomas Bryant,2528233,P,26,MIA,27,3,275,45,81,0.556,0,7,0.0,45,74,0.608,0.556,18,22,0.818,25,53,78,16,6,8,15,28,108
Kobe Bufkin,4094280,ES,20,ATL,9,0,89,13,37,0.351,5,17,0.294,8,20,0.4,0.419,2,4,0.5,2,12,14,15,3,1,5,6,33
Reggie Bullock,3196448,AL,32,HOU,26,0,226,21,52,0.404,16,41,0.39,5,11,0.455,0.558,1,1,1.0,3,32,35,10,4,2,6,15,59
Alec Burks,10489600,ES,32,TOT,54,1,1072,191,504,0.379,113,295,0.383,78,209,0.373,0.491,132,151,0.874,21,107,128,77,23,12,41,71,627
Jimmy Butler,45183960,AP,34,MIA,44,44,1501,302,597,0.506,45,102,0.441,257,495,0.519,0.544,306,359,0.852,86,159,245,216,62,15,78,49,955
Toumani Camara,1119563,AP,23,POR,60,40,1448,162,371,0.437,48,146,0.329,114,225,0.507,0.501,67,90,0.744,120,181,301,65,58,26,71,148,439
Jevon Carter,6190476,BA,28,CHI,61,0,830,115,306,0.376,65,194,0.335,50,112,0.446,0.482,3,5,0.6,7,40,47,72,32,13,30,62,298
Wendell Carter Jr.,13050000,P,24,ORL,37,31,968,155,287,0.54,45,106,0.425,110,181,0.608,0.618,71,99,0.717,74,174,248,59,17,20,45,85,426
Alex Caruso,9460000,ES,29,CHI,55,42,1513,187,402,0.465,93,245,0.38,94,157,0.599,0.581,59,76,0.776,49,154,203,162,86,62,73,141,526
Julian Champagnie,3000000,AL,22,SAS,56,41,954,106,268,0.396,70,192,0.365,36,76,0.474,0.526,48,58,0.828,34,113,147,71,32,30,36,56,330
Max Christie,1719864,ES,20,LAL,51,7,815,86,201,0.428,36,100,0.36,50,101,0.495,0.517,33,42,0.786,12,109,121,52,17,16,31,53,241
Sidy Cissoko,1119563,AL,19,SAS,6,0,32,1,6,0.167,0,4,0.0,1,2,0.5,0.167,4,4,1.0,0,6,6,0,3,0,1,2,6
Jordan Clarkson,23487629,ES,31,UTA,53,19,1616,327,791,0.413,90,303,0.297,237,488,0.486,0.47,173,196,0.883,49,135,184,267,34,6,140,77,917
Noah Clowney,3089520,AP,19,BRK,8,0,79,11,18,0.611,1,4,0.25,10,14,0.714,0.639,6,6,1.0,6,9,15,8,2,1,3,6,29
Amir Coffey,3666667,AL,26,LAC,50,9,936,105,204,0.515,40,99,0.404,65,105,0.619,0.613,45,51,0.882,18,67,85,45,28,7,21,65,295
John Collins,25340000,AP,26,UTA,60,58,1695,347,657,0.528,70,207,0.338,277,450,0.616,0.581,114,147,0.776,140,375,515,71,34,56,88,168,878
Zach Collins,7700000,P,26,SAS,52,26,1209,229,476,0.481,46,148,0.311,183,328,0.558,0.529,89,121,0.736,90,184,274,155,25,36,102,161,593
Mike Conley,24360000,BA,36,MIN,59,59,1706,209,476,0.439,129,303,0.426,80,173,0.462,0.575,72,79,0.911,27,147,174,364,62,12,70,96,619
Pat Connaughton,9423869,AL,31,MIL,58,2,1254,116,248,0.468,68,174,0.391,48,74,0.649,0.605,27,38,0.711,36,152,188,110,32,14,36,72,327
Bilal Coulibaly,6614280,AL,19,WAS,59,11,1582,173,394,0.439,57,164,0.348,116,230,0.504,0.511,82,117,0.701,51,185,236,99,50,45,82,128,485
Robert Covington,11692308,AL,33,TOT,29,6,488,43,98,0.439,19,56,0.339,24,42,0.571,0.536,22,26,0.846,31,66,97,24,39,18,11,56,127
Torrey Craig,2528233,AL,33,CHI,35,8,721,73,174,0.42,39,105,0.371,34,69,0.493,0.532,21,27,0.778,57,103,160,38,21,16,22,78,206
Jae Crowder,3196448,AP,33,MIL,33,17,804,74,177,0.418,38,111,0.342,36,66,0.545,0.525,18,26,0.692,18,102,120,48,28,6,16,56,204
Cade Cunningham,11055240,BA,22,DET,53,53,1793,443,976,0.454,105,287,0.366,338,689,0.491,0.508,206,238,0.866,27,197,224,399,45,20,186,137,1197
Seth Curry,4000000,ES,33,TOT,44,4,616,80,204,0.392,38,108,0.352,42,96,0.438,0.485,28,31,0.903,18,50,68,44,22,6,21,39,226
Stephen Curry,51915615,BA,35,GSW,59,59,1936,523,1164,0.449,290,713,0.407,233,451,0.517,0.574,254,276,0.92,30,227,257,291,46,21,176,100,1590
Dyson Daniels,5784120,BA,20,NOP,52,15,1139,112,256,0.438,32,110,0.291,80,146,0.548,0.5,32,50,0.64,51,140,191,136,72,21,52,84,288
Anthony Davis,40600080,P,30,LAL,61,61,2183,576,1038,0.555,19,74,0.257,557,964,0.578,0.564,337,413,0.816,182,566,748,221,66,149,121,146,1508
Johnny Davis,5050800,ES,21,WAS,32,0,316,31,90,0.344,5,18,0.278,26,72,0.361,0.372,6,11,0.545,14,29,43,13,10,3,8,27,73
Dexter Dennis,212331,ES,24,DAL,4,0,30,10,19,0.526,1,8,0.125,9,11,0.818,0.553,1,3,0.333,1,8,9,4,0,1,3,1,22
DeMar DeRozan,28600000,AL,34,CHI,62,62,2350,488,1034,0.472,61,178,0.343,427,856,0.499,0.501,399,462,0.864,37,228,265,333,66,36,91,134,1436
Gradey Dick,4536720,ES,20,TOR,43,2,747,102,240,0.425,54,146,0.37,48,94,0.511,0.538,23,25,0.92,21,64,85,47,22,0,26,60,281
Ousmane Dieng,4798440,AP,20,OKC,29,0,326,43,101,0.426,20,64,0.313,23,37,0.622,0.525,14,16,0.875,10,39,49,31,5,3,16,19,120
Spencer Dinwiddie,1554664,BA,30,TOT,59,49,1747,215,553,0.389,100,312,0.321,115,241,0.477,0.479,133,171,0.778,27,143,170,324,43,13,73,106,663
Donte DiVincenzo,10900000,ES,27,NYK,62,44,1638,314,711,0.442,200,495,0.404,114,216,0.528,0.582,57,78,0.731,49,163,212,160,77,24,83,121,885
Luguentz Dort,15277778,AL,24,OKC,61,61,1739,222,505,0.44,121,301,0.402,101,204,0.495,0.559,86,105,0.819,63,167,230,80,55,42,53,183,651
Ayo Dosunmu,6481481,ES,24,CHI,62,23,1701,261,532,0.491,92,230,0.4,169,302,0.56,0.577,57,73,0.781,42,125,167,178,53,29,75,129,671
Andre Drummond,3360000,P,30,CHI,64,10,1097,215,391,0.55,0,3,0.0,215,388,0.554,0.55,96,170,0.565,217,347,564,30,61,41,70,115,526
Chris Duarte,4124280,AL,26,SAC,43,11,569,60,156,0.385,32,90,0.356,28,66,0.424,0.487,21,27,0.778,19,64,83,35,23,5,20,67,173
Kris Dunn,2586484,BA,29,UTA,56,28,1029,124,256,0.484,35,90,0.389,89,166,0.536,0.553,17,25,0.68,41,115,156,220,59,23,71,109,300
Kevin Durant,47649433,AP,35,PHO,57,57,2123,586,1108,0.529,126,298,0.423,460,810,0.568,0.586,317,371,0.854,32,349,381,311,50,73,191,103,1615
Jalen Duren,4330680,P,20,DET,48,47,1431,280,448,0.625,0,3,0.0,280,445,0.629,0.625,98,126,0.778,156,407,563,126,23,40,96,161,658
Tari Eason,3527160,AP,22,HOU,22,0,480,88,189,0.466,18,50,0.36,70,139,0.504,0.513,21,33,0.636,46,107,153,27,31,19,20,51,215
Anthony Edwards,13534817,ES,22,MIN,61,60,2138,558,1208,0.462,152,408,0.373,406,800,0.508,0.525,336,400,0.84,34,284,318,306,77,33,191,114,1604
Kessler Edwards,1927896,AL,23,SAC,39,0,189,21,53,0.396,12,33,0.364,9,20,0.45,0.509,4,6,0.667,5,25,30,9,4,4,1,18,58
Keon Ellis,1450668,ES,24,SAC,37,4,437,45,104,0.433,31,82,0.378,14,22,0.636,0.582,11,17,0.647,16,35,51,46,21,14,19,52,132
Joel Embiid,47607350,P,29,PHI,34,34,1157,402,754,0.533,41,112,0.366,361,642,0.562,0.56,356,403,0.883,89,295,384,193,39,60,126,98,1201
Drew Eubanks,2346614,P,26,PHO,58,4,922,126,202,0.624,3,3,1.0,123,199,0.618,0.631,61,80,0.763,78,169,247,51,22,49,53,90,316
Dante Exum,3000000,BA,28,DAL,38,14,722,123,219,0.562,34,70,0.486,89,149,0.597,0.639,43,57,0.754,19,83,102,109,19,5,29,60,323
Bruno Fernando,2581522,P,25,ATL,26,1,315,48,87,0.552,0,3,0.0,48,84,0.571,0.552,27,44,0.614,31,64,95,16,12,16,19,46,123
Dorian Finney-Smith,13394160,AP,30,BRK,55,44,1560,181,425,0.426,106,284,0.373,75,141,0.532,0.551,22,32,0.688,93,167,260,85,42,32,50,125,490
Malachi Flynn,3873025,BA,25,TOT,54,0,607,77,193,0.399,36,106,0.34,41,87,0.471,0.492,28,37,0.757,13,67,80,89,22,6,42,51,218
Simone Fontecchio,3044872,AL,28,TOT,62,39,1500,228,498,0.458,122,305,0.4,106,193,0.549,0.58,48,59,0.814,61,159,220,96,41,20,61,100,626
Trent Forrest,968162,ES,25,ATL,25,0,250,21,56,0.375,2,7,0.286,19,49,0.388,0.393,9,12,0.75,6,25,31,49,7,1,11,21,53
Evan Fournier,18857143,ES,31,TOT,14,0,230,32,89,0.36,17,58,0.293,15,31,0.484,0.455,13,15,0.867,3,25,28,16,13,2,10,21,94
De'Aaron Fox,32600060,BA,26,SAC,54,54,1931,539,1137,0.474,149,410,0.363,390,727,0.536,0.54,242,339,0.714,50,176,226,305,104,21,145,141,1469
Alex Fudge,241285,AL,20,LAL,4,0,14,1,6,0.167,0,2,0.0,1,4,0.25,0.167,2,2,1.0,2,0,2,0,0,0,1,1,4
Markelle Fultz,17000000,BA,25,ORL,27,15,603,103,210,0.49,1,10,0.1,102,200,0.51,0.493,15,25,0.6,36,54,90,84,30,9,32,40,222
Danilo Gallinari,1047112,AP,35,TOT,40,0,551,73,170,0.429,27,84,0.321,46,86,0.535,0.509,74,86,0.86,18,80,98,50,10,5,17,43,247
Darius Garland,34005250,BA,24,CLE,39,39,1295,262,579,0.453,85,233,0.365,177,346,0.512,0.526,118,140,0.843,19,74,93,245,51,4,125,64,727
Keyonte George,3889800,BA,20,UTA,57,26,1459,228,572,0.399,114,317,0.36,114,255,0.447,0.498,129,157,0.822,14,147,161,252,27,5,121,63,699
Paul George,45640165,AP,33,LAC,57,57,1938,443,968,0.458,186,470,0.396,257,498,0.516,0.554,188,213,0.883,30,275,305,206,89,25,117,161,1260
Josh Giddey,6587160,ES,21,OKC,62,62,1531,286,626,0.457,59,179,0.33,227,447,0.508,0.504,71,86,0.826,82,293,375,274,42,34,125,80,702
Harry Giles,2092354,P,25,TOT,18,0,85,22,45,0.489,3,12,0.25,19,33,0.576,0.522,7,13,0.538,12,15,27,6,1,3,6,15,54
Anthony Gill,1997238,AP,31,WAS,33,0,175,24,51,0.471,3,13,0.231,21,38,0.553,0.5,15,20,0.75,14,25,39,14,7,6,15,12,66
Jacob Gilyard,398925,BA,25,MEM,37,14,654,60,144,0.417,51,120,0.425,9,24,0.375,0.594,2,2,1.0,8,35,43,131,27,5,29,35,173
Rudy Gobert,41000000,P,31,MIN,62,62,2104,325,501,0.649,0,3,0.0,325,498,0.653,0.649,203,313,0.649,227,573,800,75,38,133,96,193,853
Jordan Goodwin,1927986,BA,25,TOT,46,5,730,93,248,0.375,28,98,0.286,65,150,0.433,0.431,29,39,0.744,50,93,143,106,33,16,39,52,243
Aaron Gordon,21266182,AP,28,DEN,58,58,1822,318,575,0.553,31,108,0.287,287,467,0.615,0.58,133,204,0.652,137,238,375,188,50,37,85,111,800
Eric Gordon,3196448,ES,35,PHO,53,24,1564,232,520,0.446,125,329,0.38,107,191,0.56,0.566,46,58,0.793,15,93,108,117,50,25,64,63,635
Devonte' Graham,12100000,BA,28,SAS,13,0,111,14,34,0.412,9,24,0.375,5,10,0.5,0.544,6,8,0.75,2,16,18,19,4,1,3,6,43
Jerami Grant,27586207,AP,29,POR,53,53,1795,378,836,0.452,110,272,0.404,268,564,0.475,0.518,252,309,0.816,37,152,189,150,43,34,114,117,1118
A.J. Green,1801769,ES,24,MIL,42,0,401,61,141,0.433,50,122,0.41,11,19,0.579,0.61,10,11,0.909,6,39,45,26,3,2,7,36,182
Draymond Green,22321429,AP,33,GSW,39,36,1033,135,270,0.5,41,95,0.432,94,175,0.537,0.576,45,59,0.763,50,224,274,232,30,37,95,118,356
Jalen Green,9891600,ES,21,HOU,63,63,1939,404,979,0.413,136,431,0.316,268,548,0.489,0.482,212,262,0.809,27,276,303,211,48,20,139,83,1156
Jeff Green,9600000,AP,37,HOU,59,5,966,113,242,0.467,27,88,0.307,86,154,0.558,0.523,98,121,0.81,34,91,125,51,10,26,40,82,351
Josh Green,4765339,ES,23,DAL,51,32,1385,167,344,0.485,69,172,0.401,98,172,0.57,0.586,37,55,0.673,36,130,166,122,45,9,55,101,440
Quentin Grimes,2385720,ES,23,TOT,49,18,989,120,314,0.382,81,231,0.351,39,83,0.47,0.511,27,37,0.73,14,82,96,60,34,7,26,70,348
Rui Hachimura,15740741,AP,25,LAL,51,22,1302,250,483,0.518,67,165,0.406,183,318,0.575,0.587,70,99,0.707,39,152,191,53,36,16,36,74,637
Tyrese Haliburton,5808435,BA,23,IND,51,50,1635,383,793,0.483,150,398,0.377,233,395,0.59,0.578,145,171,0.848,30,164,194,580,54,33,119,48,1061
R.J. Hampton,120250,BA,22,MIA,8,2,76,4,14,0.286,1,8,0.125,3,6,0.5,0.321,1,2,0.5,2,4,6,8,0,0,3,8,10
Tim Hardaway Jr.,17897728,AL,31,DAL,61,10,1737,338,830,0.407,182,504,0.361,156,326,0.479,0.517,130,152,0.855,19,190,209,101,29,5,57,90,988
James Harden,35640000,BA,34,LAC,57,57,1974,293,657,0.446,160,392,0.408,133,265,0.502,0.568,257,292,0.88,25,270,295,473,62,52,146,109,1003
Jaden Hardy,1719864,ES,21,DAL,56,6,807,159,392,0.406,70,192,0.365,89,200,0.445,0.495,44,59,0.746,15,87,102,87,17,4,41,58,432
Gary Harris,13000000,ES,29,ORL,40,13,918,101,221,0.457,57,150,0.38,44,71,0.62,0.586,28,37,0.757,18,48,66,69,37,11,21,68,287
Joe Harris,19928571,ES,32,DET,16,0,170,14,39,0.359,10,30,0.333,4,9,0.444,0.487,1,2,0.5,3,10,13,10,3,2,4,19,39
Tobias Harris,39270150,AP,31,PHI,57,57,1937,385,777,0.495,70,203,0.345,315,574,0.549,0.541,160,179,0.894,64,290,354,183,59,32,76,96,1000
Josh Hart,12960000,AL,28,NYK,62,23,1959,212,493,0.43,69,206,0.335,143,287,0.498,0.5,61,80,0.763,88,384,472,221,52,20,84,120,554
Isaiah Hartenstein,8195121,P,25,NYK,57,31,1425,156,258,0.605,1,3,0.333,155,255,0.608,0.607,80,110,0.727,188,288,476,123,62,63,67,159,393
Sam Hauser,1927896,AL,26,BOS,62,6,1286,166,373,0.445,134,322,0.416,32,51,0.627,0.625,15,17,0.882,36,170,206,56,23,18,28,80,481
Jordan Hawkins,4310160,ES,21,NOP,55,10,1075,167,428,0.39,104,281,0.37,63,147,0.429,0.512,64,75,0.853,28,113,141,65,17,6,38,68,502
Jaxson Hayes,2165000,P,23,LAL,54,3,617,85,123,0.691,0,8,0.0,85,115,0.739,0.691,33,55,0.6,46,91,137,24,26,22,26,89,203
Killian Hayes,7413955,BA,22,DET,42,31,1008,117,283,0.413,22,74,0.297,95,209,0.455,0.452,33,50,0.66,11,108,119,205,36,20,51,75,289
Gordon Hayward,31500000,AL,33,TOT,34,25,936,150,331,0.453,24,65,0.369,126,266,0.474,0.489,68,89,0.764,31,113,144,127,31,12,54,52,392
Scoot Henderson,9770880,BA,19,POR,44,16,1186,195,518,0.376,53,172,0.308,142,346,0.41,0.428,123,150,0.82,38,90,128,207,25,10,128,133,566
Taylor Hendricks,5569920,AP,20,UTA,23,6,401,51,116,0.44,23,68,0.338,28,48,0.583,0.539,9,11,0.818,27,64,91,13,14,13,17,40,134
Tyler Herro,27000000,ES,24,MIA,36,36,1209,283,648,0.437,117,293,0.399,166,355,0.468,0.527,66,79,0.835,18,173,191,158,29,3,77,51,749
Buddy Hield,19279841,ES,31,TOT,65,41,1757,299,685,0.436,180,463,0.389,119,222,0.536,0.568,38,44,0.864,41,169,210,203,60,35,84,139,816
Haywood Highsmith,1902137,AP,27,MIA,47,24,945,97,226,0.429,49,135,0.363,48,91,0.527,0.538,21,26,0.808,39,90,129,46,42,25,26,89,264
D'Moi Hodge,241285,ES,25,LAL,7,0,41,5,15,0.333,3,12,0.25,2,3,0.667,0.433,1,2,0.5,0,0,0,5,1,1,1,4,14
Aaron Holiday,2346614,BA,27,HOU,60,1,1001,146,323,0.452,70,172,0.407,76,151,0.503,0.56,40,45,0.889,16,84,100,108,32,5,45,94,402
Jrue Holiday,36158747,BA,33,BOS,58,58,1924,285,588,0.485,119,267,0.446,166,321,0.517,0.586,58,70,0.829,74,249,323,279,51,42,108,95,747
Justin Holiday,3196448,ES,34,DEN,40,9,587,58,124,0.468,36,88,0.409,22,36,0.611,0.613,3,4,0.75,6,43,49,46,24,5,9,49,155
Richaun Holmes,12046020,AP,30,TOT,33,3,383,57,99,0.576,1,1,1.0,56,98,0.571,0.581,22,32,0.688,47,70,117,19,8,13,16,52,137
Chet Holmgren,10386000,P,21,OKC,63,63,1902,402,744,0.54,106,271,0.391,296,473,0.626,0.612,162,206,0.786,101,389,490,172,41,157,101,154,1072
Jalen Hood-Schifino,3695040,ES,20,LAL,21,0,109,10,45,0.222,2,15,0.133,8,30,0.267,0.244,12,20,0.6,2,11,13,8,3,2,9,13,34
Al Horford,10000000,P,37,BOS,53,24,1413,158,326,0.485,79,202,0.391,79,124,0.637,0.606,19,22,0.864,68,284,352,140,29,51,37,80,414
Talen Horton-Tucker,11020000,BA,23,UTA,41,11,805,146,364,0.401,46,139,0.331,100,225,0.444,0.464,72,90,0.8,20,83,103,153,36,15,55,75,410
Caleb Houstan,2000000,AL,21,ORL,47,9,674,68,172,0.395,61,161,0.379,7,11,0.636,0.573,19,24,0.792,23,51,74,26,12,3,15,52,216
Jett Howard,5026800,AL,20,ORL,13,0,49,8,22,0.364,5,17,0.294,3,5,0.6,0.477,2,4,0.5,1,4,5,3,0,1,2,3,23
Kevin Huerter,15669643,ES,25,SAC,60,55,1494,241,540,0.446,120,328,0.366,121,212,0.571,0.557,36,47,0.766,38,176,214,157,39,22,50,126,638
De'Andre Hunter,20089286,AL,26,ATL,39,24,1097,201,418,0.481,78,183,0.426,123,235,0.523,0.574,120,140,0.857,22,124,146,50,30,12,53,107,600
Bones Hyland,2306400,BA,23,LAC,24,2,316,53,143,0.371,24,75,0.32,29,68,0.426,0.455,11,14,0.786,3,18,21,45,13,2,27,31,141
Joe Ingles,11000000,AL,36,ORL,50,0,862,74,180,0.411,50,123,0.407,24,57,0.421,0.55,19,23,0.826,17,90,107,148,33,4,45,69,217
Brandon Ingram,33833400,AL,26,NOP,57,57,1892,458,928,0.494,81,222,0.365,377,706,0.534,0.537,235,292,0.805,40,247,287,330,45,35,151,131,1232
Kyrie Irving,37037037,ES,31,DAL,42,42,1439,407,831,0.49,126,301,0.419,281,530,0.53,0.566,131,146,0.897,32,180,212,210,50,19,71,77,1071
Jonathan Isaac,17400000,AP,26,ORL,43,1,636,100,202,0.495,22,70,0.314,78,132,0.591,0.55,48,67,0.716,54,129,183,19,31,49,22,44,270
Jaden Ivey,7614480,ES,21,DET,59,43,1668,317,718,0.442,92,269,0.342,225,449,0.501,0.506,183,243,0.753,75,133,208,214,43,34,144,168,909
Andre Jackson Jr.,1119563,ES,22,MIL,48,8,504,46,88,0.523,15,40,0.375,31,48,0.646,0.608,8,11,0.727,36,58,94,44,14,4,22,82,115
Isaiah Jackson,2696280,P,22,IND,47,3,637,132,199,0.663,0,4,0.0,132,195,0.677,0.663,63,88,0.716,72,121,193,40,29,51,35,118,327
Jaren Jackson Jr.,27102202,P,24,MEM,56,56,1795,435,979,0.444,102,317,0.322,333,662,0.503,0.496,291,358,0.813,70,247,317,120,63,89,133,198,1263
Reggie Jackson,5000000,BA,33,DEN,64,16,1427,258,584,0.442,77,218,0.353,181,366,0.495,0.508,52,67,0.776,23,103,126,241,34,10,80,113,645
LeBron James,47607350,AP,39,LAL,56,56,1962,535,1013,0.528,122,301,0.405,413,712,0.58,0.588,223,301,0.741,47,348,395,448,71,33,180,65,1415
Jaime Jaquez Jr.,3510600,AL,22,MIA,57,17,1679,284,568,0.5,53,160,0.331,231,408,0.566,0.547,114,141,0.809,70,157,227,147,64,11,90,131,735
DaQuan Jeffries,951635,ES,26,NYK,13,0,34,5,14,0.357,1,7,0.143,4,7,0.571,0.393,0,2,0.0,0,5,5,2,0,0,1,2,11
Isaiah Joe,1997238,ES,24,OKC,59,0,1087,168,364,0.462,111,267,0.416,57,97,0.588,0.614,34,40,0.85,24,111,135,66,35,17,36,67,481
Cameron Johnson,25700000,AP,27,BRK,49,45,1359,243,537,0.453,120,303,0.396,123,234,0.526,0.564,68,88,0.773,50,166,216,122,41,13,48,92,674
Jalen Johnson,2925480,AL,22,ATL,48,45,1630,304,582,0.522,56,162,0.346,248,420,0.59,0.57,88,121,0.727,63,351,414,165,55,43,83,122,752
James Johnson,2608596,AP,36,IND,6,0,32,2,6,0.333,0,1,0.0,2,5,0.4,0.333,2,2,1.0,1,3,4,6,4,1,2,7,6
Keldon Johnson,20000000,AL,24,SAS,60,26,1777,351,776,0.452,111,321,0.346,240,455,0.527,0.524,148,189,0.783,83,246,329,178,47,18,90,133,961
Keon Johnson,2808720,ES,21,BRK,4,0,51,7,19,0.368,4,9,0.444,3,10,0.3,0.474,10,10,1.0,3,2,5,3,3,1,4,4,28
Colby Jones,2019706,ES,21,SAC,17,0,121,17,46,0.37,1,13,0.077,16,33,0.485,0.38,2,5,0.4,10,15,25,10,4,1,5,16,37
Damian Jones,2586665,P,28,CLE,27,0,167,18,35,0.514,2,7,0.286,16,28,0.571,0.543,10,11,0.909,10,27,37,12,3,11,10,18,48
Derrick Jones Jr.,2709849,AL,26,DAL,59,49,1397,192,391,0.491,68,194,0.351,124,197,0.629,0.578,75,104,0.721,63,141,204,57,45,40,52,96,527
Herbert Jones,12015150,AL,25,NOP,58,58,1702,234,456,0.513,90,207,0.435,144,249,0.578,0.612,99,116,0.853,62,147,209,143,74,45,68,168,657
Tre Jones,9895833,BA,24,SAS,59,30,1555,217,431,0.503,41,133,0.308,176,298,0.591,0.551,82,94,0.872,40,157,197,356,56,7,85,69,557
Tyus Jones,14000000,BA,27,WAS,63,63,1829,315,637,0.495,101,241,0.419,214,396,0.54,0.574,30,38,0.789,20,154,174,452,69,18,62,47,761
Cory Joseph,3196448,BA,32,GSW,26,0,296,23,64,0.359,13,42,0.31,10,22,0.455,0.461,4,7,0.571,6,24,30,42,4,3,12,25,63
Luke Kennard,15418363,ES,27,MEM,32,15,799,115,250,0.46,88,191,0.461,27,59,0.458,0.636,38,43,0.884,9,80,89,97,15,1,37,34,356
Walker Kessler,2831160,P,22,UTA,52,18,1213,194,302,0.642,4,19,0.211,190,283,0.671,0.649,46,81,0.568,137,253,390,46,26,139,53,110,438
Corey Kispert,3722040,AL,24,WAS,61,3,1390,266,558,0.477,123,341,0.361,143,217,0.659,0.587,88,113,0.779,19,136,155,105,26,11,70,99,743
Maxi Kleber,11000000,P,32,DAL,27,7,589,44,106,0.415,21,65,0.323,23,41,0.561,0.514,19,29,0.655,18,79,97,43,9,19,20,54,128
Kevin Knox,2144320,AL,24,DET,31,11,560,86,186,0.462,31,94,0.33,55,92,0.598,0.546,20,22,0.909,18,57,75,23,13,7,22,50,223
John Konchar,2400000,AL,27,MEM,49,18,981,75,177,0.424,31,101,0.307,44,76,0.579,0.511,17,20,0.85,60,154,214,90,41,47,36,64,198
Furkan Korkmaz,5370370,ES,26,PHI,35,0,300,30,76,0.395,14,40,0.35,16,36,0.444,0.487,14,20,0.7,4,26,30,25,14,3,10,17,88
Jonathan Kuminga,6012720,AP,21,GSW,62,36,1601,375,706,0.531,42,140,0.3,333,566,0.588,0.561,191,259,0.737,82,216,298,129,43,30,99,135,983
Kyle Kuzma,25568182,AP,28,WAS,61,61,1957,534,1155,0.462,140,414,0.338,394,741,0.532,0.523,155,199,0.779,59,340,399,254,31,44,158,132,1363
Jock Landale,8000000,P,28,HOU,37,0,335,33,86,0.384,3,20,0.15,30,66,0.455,0.401,19,24,0.792,49,39,88,25,9,14,12,36,88
Jake LaRavia,3199920,AP,22,MEM,19,0,312,43,118,0.364,14,58,0.241,29,60,0.483,0.424,32,40,0.8,24,36,60,20,10,7,15,35,132
Zach LaVine,40064220,ES,28,CHI,25,23,872,170,376,0.452,59,169,0.349,111,207,0.536,0.531,88,103,0.854,8,121,129,98,21,8,52,57,487
Alex Len,3196448,P,30,SAC,28,0,247,31,54,0.574,0,3,0.0,31,51,0.608,0.574,7,17,0.412,33,50,83,25,8,15,18,32,69
Kawhi Leonard,45640084,AL,32,LAC,57,57,1972,515,985,0.523,123,289,0.426,392,696,0.563,0.585,215,241,0.892,70,285,355,214,98,48,96,85,1368
Caris LeVert,15384616,ES,29,CLE,51,1,1429,260,630,0.413,85,258,0.329,175,372,0.47,0.48,108,144,0.75,27,170,197,245,50,24,79,89,713
Kira Lewis Jr.,5722116,BA,22,TOT,19,0,153,17,54,0.315,2,21,0.095,15,33,0.455,0.333,10,11,0.909,5,10,15,21,6,1,8,9,46
E.J. Liddell,1801769,AP,23,NOP,8,0,23,1,6,0.167,0,5,0.0,1,1,1.0,0.167,2,2,1.0,0,5,5,1,2,2,2,2,4
Damian Lillard,45640084,BA,33,MIL,59,59,2062,437,1032,0.423,177,506,0.35,260,526,0.494,0.509,395,426,0.927,30,225,255,400,61,12,152,105,1446
Nassir Little,6250000,AL,23,PHO,34,2,426,49,107,0.458,19,60,0.317,30,47,0.638,0.547,17,20,0.85,14,57,71,19,10,10,13,37,134
Dereck Lively II,4775640,P,19,DAL,45,42,1108,176,237,0.743,0,2,0.0,176,235,0.749,0.743,37,70,0.529,119,197,316,52,31,65,44,129,389
Isaiah Livers,1836096,AP,25,DET,23,6,469,40,116,0.345,22,77,0.286,18,39,0.462,0.44,12,18,0.667,15,33,48,25,13,5,16,43,114
Chris Livingston,1119563,AL,20,MIL,16,0,69,7,16,0.438,1,3,0.333,6,13,0.462,0.469,2,2,1.0,2,13,15,5,2,0,4,11,17
Kevon Looney,7500000,P,27,GSW,61,36,1033,116,195,0.595,0,1,0.0,116,194,0.598,0.595,46,68,0.676,125,236,361,123,24,22,44,132,278
Brook Lopez,25000000,P,35,MIL,61,61,1900,286,599,0.477,111,315,0.352,175,284,0.616,0.57,83,101,0.822,90,235,325,101,37,159,54,150,766
Robin Lopez,3196448,P,35,MIL,16,2,65,7,19,0.368,2,8,0.25,5,11,0.455,0.421,2,2,1.0,3,2,5,4,1,3,2,7,18
Kevin Love,3835738,AP,35,MIA,47,5,822,135,305,0.443,74,212,0.349,61,93,0.656,0.564,81,104,0.779,50,242,292,105,16,9,38,85,425
Kyle Lowry,1138964,BA,37,TOT,44,39,1243,122,286,0.427,73,188,0.388,49,98,0.5,0.554,46,54,0.852,30,122,152,188,46,16,63,109,363
Trey Lyles,8000000,AP,28,SAC,47,0,940,117,257,0.455,69,178,0.388,48,79,0.608,0.589,41,59,0.695,47,163,210,55,13,14,30,75,344
Théo Maledon,167291,BA,22,TOT,17,1,213,20,70,0.286,5,30,0.167,15,40,0.375,0.321,14,15,0.933,4,20,24,28,7,0,18,21,59
Terance Mann,10576923,ES,27,LAC,56,52,1413,176,358,0.492,51,154,0.331,125,204,0.613,0.563,51,64,0.797,69,122,191,99,28,11,35,105,454
Tre Mann,3191280,BA,22,TOT,24,11,454,68,148,0.459,25,61,0.41,43,87,0.494,0.544,16,20,0.8,9,72,81,72,21,0,26,25,177
Lauri Markkanen,17259999,AP,26,UTA,51,51,1677,395,818,0.483,164,409,0.401,231,409,0.565,0.583,222,250,0.888,115,306,421,103,44,24,67,95,1176
Naji Marshall,1930681,AL,26,NOP,51,1,964,131,284,0.461,45,116,0.388,86,168,0.512,0.54,63,80,0.788,48,135,183,103,37,11,56,73,370
Caleb Martin,6802950,AL,28,MIA,46,19,1250,180,398,0.452,61,156,0.391,119,242,0.492,0.529,58,75,0.773,54,157,211,94,32,19,54,101,479
Cody Martin,7560000,AL,28,CHO,28,22,753,82,215,0.381,27,86,0.314,55,129,0.426,0.444,20,33,0.606,19,90,109,104,32,18,44,48,211
Garrison Mathews,2000000,ES,27,ATL,47,4,609,52,120,0.433,47,109,0.431,5,11,0.455,0.629,13,18,0.722,14,50,64,20,11,4,15,76,164
Bennedict Mathurin,6916080,AL,21,IND,59,19,1538,296,663,0.446,80,214,0.374,216,449,0.481,0.507,184,224,0.821,60,174,234,119,35,14,97,117,856
Wesley Matthews,3196448,ES,37,ATL,23,1,250,15,48,0.313,10,37,0.27,5,11,0.455,0.417,14,20,0.7,4,29,33,13,10,6,6,29,54
Tyrese Maxey,4343920,BA,23,PHI,55,55,2056,497,1108,0.449,168,445,0.378,329,663,0.496,0.524,269,309,0.871,31,175,206,345,56,27,94,121,1431
Skylar Mays,914343,BA,26,TOT,31,5,419,62,156,0.397,16,54,0.296,46,102,0.451,0.449,13,17,0.765,10,32,42,83,17,4,19,25,153
Miles McBride,1836096,BA,23,NYK,50,5,741,122,277,0.44,63,155,0.406,59,122,0.484,0.554,23,28,0.821,16,39,55,68,32,5,19,65,330
T.J. McConnell,8700000,BA,31,IND,53,4,929,212,385,0.551,7,24,0.292,205,361,0.568,0.56,37,48,0.771,29,111,140,289,56,5,78,56,468
Jaden McDaniels,3901399,AL,23,MIN,54,53,1577,230,456,0.504,66,183,0.361,164,273,0.601,0.577,42,56,0.75,40,116,156,78,45,30,67,169,568
Jalen McDaniels,4516000,AL,26,TOR,36,0,325,37,110,0.336,11,54,0.204,26,56,0.464,0.386,14,20,0.7,10,42,52,20,13,4,19,33,99
Doug McDermott,13750000,AL,32,TOT,52,0,766,102,239,0.427,80,193,0.415,22,46,0.478,0.594,11,19,0.579,9,42,51,61,11,2,25,51,295
JaVale McGee,3196448,P,36,SAC,39,0,310,73,116,0.629,0,4,0.0,73,112,0.652,0.629,25,43,0.581,37,75,112,14,9,19,31,44,171
Bryce McGowens,1719864,ES,21,CHO,50,13,789,88,194,0.454,30,88,0.341,58,106,0.547,0.531,52,69,0.754,16,75,91,46,20,7,26,70,258
Jordan McLaughlin,2320000,BA,27,MIN,38,0,339,36,85,0.424,21,49,0.429,15,36,0.417,0.547,6,10,0.6,10,29,39,67,26,6,13,21,99
De'Anthony Melton,8000000,ES,25,PHI,36,33,1002,136,348,0.391,75,207,0.362,61,141,0.433,0.499,66,79,0.835,27,110,137,110,56,16,39,82,413
Sam Merrill,1997238,ES,27,CLE,45,1,729,118,284,0.415,104,250,0.416,14,34,0.412,0.599,12,13,0.923,18,69,87,67,15,1,12,51,352
Chimezie Metu,2346614,P,26,PHO,37,5,447,66,130,0.508,15,51,0.294,51,79,0.646,0.565,38,43,0.884,24,86,110,19,19,9,27,39,185
Khris Middleton,29320988,AL,32,MIL,43,43,1129,242,497,0.487,73,193,0.378,169,304,0.556,0.56,79,95,0.832,26,158,184,216,38,13,89,104,636
Brandon Miller,10880400,AL,21,CHO,57,51,1828,365,828,0.441,134,359,0.373,231,469,0.493,0.522,101,122,0.828,48,194,242,133,50,31,103,146,965
Dariq Whitehead,2966040,AL,19,BRK,2,0,24,1,5,0.2,0,3,0.0,1,2,0.5,0.2,1,2,0.5,0,4,4,3,0,1,0,0,3
Shake Milton,5000000,ES,27,TOT,43,0,555,75,186,0.403,17,62,0.274,58,124,0.468,0.449,38,47,0.809,14,55,69,56,18,6,31,47,205
Josh Minott,1719864,AL,21,MIN,21,0,62,10,21,0.476,1,6,0.167,9,15,0.6,0.5,12,14,0.857,3,9,12,3,3,3,2,7,33
Davion Mitchell,5063760,BA,25,SAC,52,4,700,88,192,0.458,33,96,0.344,55,96,0.573,0.544,20,27,0.741,8,46,54,87,11,3,29,65,229
Donovan Mitchell,32600060,ES,27,CLE,47,47,1679,454,961,0.472,159,428,0.371,295,533,0.553,0.555,248,288,0.861,42,212,254,290,85,24,137,106,1315
Evan Mobley,8882760,AP,22,CLE,38,38,1183,247,427,0.578,11,35,0.314,236,392,0.602,0.591,88,125,0.704,92,296,388,116,34,59,73,108,593
Malik Monk,9945830,ES,25,SAC,61,0,1596,338,753,0.449,136,364,0.374,202,389,0.519,0.539,139,171,0.813,22,156,178,326,39,37,133,124,951
Moses Moody,3918480,ES,21,GSW,49,8,875,148,324,0.457,50,153,0.327,98,171,0.573,0.534,56,71,0.789,54,103,157,37,33,20,35,60,402
Ja Morant,34005250,BA,24,MEM,9,9,318,80,170,0.471,14,51,0.275,66,119,0.555,0.512,52,64,0.813,6,44,50,73,7,5,27,19,226
Marcus Morris,17116279,AP,34,PHI,37,7,637,90,205,0.439,36,90,0.4,54,115,0.47,0.527,31,36,0.861,18,91,109,26,13,11,19,61,247
Markieff Morris,3196448,AP,34,DAL,19,1,163,18,51,0.353,12,32,0.375,6,19,0.316,0.471,3,4,0.75,4,26,30,11,5,1,10,11,51
Monte Morris,9800926,BA,28,TOT,17,0,241,34,90,0.378,11,36,0.306,23,54,0.426,0.439,6,9,0.667,5,24,29,40,8,3,4,6,85
Trey Murphy III,3359280,AL,23,NOP,38,10,1028,172,393,0.438,107,286,0.374,65,107,0.607,0.574,66,87,0.759,25,133,158,70,33,20,16,47,517
Dejounte Murray,18214000,ES,27,ATL,60,60,2109,503,1076,0.467,137,381,0.36,366,695,0.527,0.531,166,205,0.81,43,276,319,343,78,19,138,100,1309
Jamal Murray,33833400,BA,26,DEN,48,48,1526,384,799,0.481,117,277,0.422,267,522,0.511,0.554,126,148,0.851,32,159,191,313,42,30,103,87,1011
Keegan Murray,8409000,AL,23,SAC,58,58,1909,325,701,0.464,127,353,0.36,198,348,0.569,0.554,77,93,0.828,72,230,302,95,62,40,50,158,854
Kris Murray,2847480,AL,23,POR,43,10,723,77,192,0.401,25,95,0.263,52,97,0.536,0.466,19,31,0.613,41,76,117,48,35,9,29,49,198
Mike Muscala,808297,P,32,TOT,38,6,520,50,139,0.36,28,88,0.318,22,51,0.431,0.46,17,24,0.708,32,75,107,32,8,12,18,44,145
Svi Mykhailiuk,2346614,AL,26,BOS,26,0,206,26,74,0.351,19,59,0.322,7,15,0.467,0.48,3,6,0.5,8,18,26,14,8,0,8,12,74
Andrew Nembhard,2131905,BA,24,IND,50,29,1187,192,388,0.495,42,116,0.362,150,272,0.551,0.549,30,38,0.789,30,70,100,214,49,4,83,99,456
Aaron Nesmith,5634257,AL,24,IND,55,30,1481,242,478,0.506,112,252,0.444,130,226,0.575,0.623,75,105,0.714,48,159,207,80,55,36,52,181,671
Georges Niang,8800000,AP,30,CLE,63,3,1362,204,467,0.437,107,292,0.366,97,175,0.554,0.551,37,45,0.822,19,205,224,78,18,14,50,144,552
Zeke Nnaji,4306281,AP,23,DEN,49,0,482,56,130,0.431,5,21,0.238,51,109,0.468,0.45,42,59,0.712,56,51,107,28,13,33,27,70,159
Jaylen Nowell,248850,ES,24,MEM,9,1,156,22,55,0.4,4,23,0.174,18,32,0.563,0.436,3,3,1.0,3,11,14,16,3,0,5,13,51
Frank Ntilikina,2528233,BA,25,CHO,5,0,43,1,9,0.111,1,8,0.125,0,1,0.0,0.167,2,2,1.0,1,5,6,4,0,0,1,4,5
Jordan Nwora,3200000,AL,25,TOT,35,1,380,70,165,0.424,23,73,0.315,47,92,0.511,0.494,29,33,0.879,17,54,71,37,13,4,20,35,192
Royce O'Neale,9500000,AL,30,TOT,61,12,1556,165,429,0.385,126,342,0.368,39,87,0.448,0.531,21,31,0.677,48,247,295,180,49,37,59,145,477
Chuma Okeke,5266713,AL,25,ORL,38,8,395,39,104,0.375,23,76,0.303,16,28,0.571,0.486,2,5,0.4,18,56,74,18,8,7,12,19,103
Josh Okogie,2815937,ES,25,PHO,54,11,926,83,199,0.417,27,91,0.297,56,108,0.519,0.485,74,100,0.74,71,77,148,62,47,22,33,65,267
Onyeka Okongwu,8109063,P,23,ATL,53,8,1367,214,351,0.61,22,65,0.338,192,286,0.671,0.641,92,115,0.8,143,226,369,71,23,59,45,158,542
Isaac Okoro,8920795,AL,23,CLE,54,31,1448,190,378,0.503,66,164,0.402,124,214,0.579,0.59,77,112,0.688,56,109,165,109,47,30,41,108,523
Kelly Olynyk,12195122,P,32,TOT,62,11,1294,187,349,0.536,46,116,0.397,141,233,0.605,0.602,110,131,0.84,81,227,308,262,57,21,100,169,530
Eugene Omoruyi,940566,AL,26,WAS,31,0,233,53,109,0.486,6,27,0.222,47,82,0.573,0.514,24,33,0.727,26,37,63,23,19,1,15,43,136
Cedi Osman,6718842,AL,28,SAS,63,1,1099,158,333,0.474,71,190,0.374,87,143,0.608,0.581,34,50,0.68,23,134,157,107,33,9,42,92,421
Chris Paul,30800000,BA,38,GSW,39,12,1048,128,297,0.431,56,148,0.378,72,149,0.483,0.525,40,48,0.833,12,134,146,277,52,3,46,66,352
Cameron Payne,2891467,BA,29,TOT,59,5,948,149,335,0.445,71,186,0.382,78,149,0.523,0.551,53,61,0.869,12,70,82,148,28,5,43,92,422
Gary Payton II,8715000,ES,31,GSW,28,0,435,68,127,0.535,14,40,0.35,54,87,0.621,0.591,9,14,0.643,34,49,83,27,29,10,17,45,159
Julian Phillips,1600000,AL,20,CHI,38,0,283,29,68,0.426,10,34,0.294,19,34,0.559,0.5,10,16,0.625,10,22,32,13,5,6,9,38,78
Jalen Pickett,1708143,ES,24,DEN,21,0,108,12,30,0.4,7,22,0.318,5,8,0.625,0.517,3,4,0.75,1,10,11,15,3,0,8,11,34
Brandin Podziemski,3352440,ES,20,GSW,55,22,1476,209,464,0.45,68,183,0.372,141,281,0.502,0.524,43,70,0.614,86,231,317,216,46,11,69,95,529
Aleksej Pokusevski,565176,AP,22,TOT,11,0,68,6,18,0.333,3,12,0.25,3,6,0.5,0.417,4,6,0.667,2,10,12,5,2,2,4,5,19
Jordan Poole,28705357,ES,24,WAS,61,52,1795,365,899,0.406,132,419,0.315,233,480,0.485,0.479,156,181,0.862,23,133,156,231,68,23,139,199,1018
Craig Porter Jr.,1866574,BA,23,CLE,39,5,522,95,187,0.508,7,23,0.304,88,164,0.537,0.527,35,49,0.714,18,72,90,98,19,12,36,34,232
Michael Porter Jr.,33386850,AL,25,DEN,63,63,1997,403,836,0.482,173,436,0.397,230,400,0.575,0.586,64,78,0.821,83,359,442,93,31,45,71,121,1043
Bobby Portis,11710818,AP,28,MIL,64,1,1537,344,687,0.501,75,198,0.379,269,489,0.55,0.555,85,107,0.794,103,351,454,75,47,24,64,153,848
Dwight Powell,4000000,P,32,DAL,52,8,748,68,97,0.701,1,2,0.5,67,95,0.705,0.706,61,84,0.726,82,102,184,76,23,19,29,104,198
Norman Powell,18000000,ES,30,LAC,61,1,1574,297,606,0.49,135,303,0.446,162,303,0.535,0.601,104,126,0.825,12,146,158,63,35,20,54,110,833
Taurean Prince,4516000,AP,29,LAL,62,49,1771,206,472,0.436,118,302,0.391,88,170,0.518,0.561,38,53,0.717,15,170,185,102,49,29,56,127,568
Payton Pritchard,4037278,BA,26,BOS,63,0,1278,183,412,0.444,105,275,0.382,78,137,0.569,0.572,30,37,0.811,54,142,196,166,28,6,41,79,501
Immanuel Quickley,4171548,ES,24,TOT,59,29,1691,332,760,0.437,150,369,0.407,182,391,0.465,0.536,156,186,0.839,14,197,211,263,40,8,79,96,970
Julius Randle,25660800,AP,29,NYK,46,46,1630,395,836,0.472,76,244,0.311,319,592,0.539,0.518,236,302,0.781,99,324,423,229,25,12,159,125,1102
Duop Reath,2324408,P,27,POR,49,16,897,172,362,0.475,68,182,0.374,104,180,0.578,0.569,52,73,0.712,75,113,188,53,25,29,40,126,464
Austin Reaves,12015150,ES,25,LAL,65,40,2052,360,729,0.494,117,312,0.375,243,417,0.583,0.574,185,215,0.86,43,220,263,362,57,14,139,119,1022
Cam Reddish,2165000,AL,24,LAL,40,26,886,88,217,0.406,35,102,0.343,53,115,0.461,0.486,37,48,0.771,22,69,91,47,45,12,31,59,248
Paul Reed,7723000,P,24,PHI,63,23,1171,194,358,0.542,16,42,0.381,178,316,0.563,0.564,38,51,0.745,144,215,359,81,44,57,44,153,442
Naz Reid,12950400,P,24,MIN,64,0,1484,301,624,0.482,124,298,0.416,177,326,0.543,0.582,82,108,0.759,62,251,313,71,44,52,79,130,808
Nick Richards,5000000,P,26,CHO,54,41,1419,212,307,0.691,0,1,0.0,212,306,0.693,0.691,114,155,0.735,146,291,437,43,21,68,60,144,538
Josh Richardson,2891467,ES,30,MIA,43,6,1103,154,347,0.444,66,190,0.347,88,157,0.561,0.539,51,54,0.944,18,103,121,105,24,14,36,76,425
Duncan Robinson,18154000,AL,29,MIA,58,26,1639,269,587,0.458,165,403,0.409,104,184,0.565,0.599,72,81,0.889,12,132,144,173,39,14,78,137,775
Orlando Robinson,1801769,P,23,MIA,27,7,273,33,67,0.493,7,14,0.5,26,53,0.491,0.545,18,24,0.75,23,55,78,29,7,7,17,35,91
David Roddy,2718240,AP,22,TOT,55,13,1146,159,396,0.402,48,162,0.296,111,234,0.474,0.462,47,68,0.691,52,151,203,76,25,11,55,70,413
Ryan Rollins,1719864,BA,21,WAS,10,0,66,13,25,0.52,2,3,0.667,11,22,0.5,0.56,13,17,0.765,2,9,11,11,8,3,7,7,41
Derrick Rose,3196448,BA,35,MEM,24,7,399,76,165,0.461,15,41,0.366,61,124,0.492,0.506,24,27,0.889,7,38,45,78,8,2,31,21,191
Terry Rozier,23205221,ES,29,TOT,46,45,1564,339,763,0.444,108,312,0.346,231,451,0.512,0.515,146,168,0.869,29,157,186,292,45,16,87,82,932
Rayan Rupert,1119563,ES,19,POR,22,0,209,23,63,0.365,12,29,0.414,11,34,0.324,0.46,7,10,0.7,13,23,36,20,5,0,11,19,65
D'Angelo Russell,17307693,BA,27,LAL,60,53,1914,398,844,0.472,171,403,0.424,227,441,0.515,0.573,120,149,0.805,23,155,178,374,51,30,119,128,1087
Domantas Sabonis,30600000,P,27,SAC,62,62,2218,503,825,0.61,29,69,0.42,474,756,0.627,0.627,205,296,0.693,217,621,838,523,55,34,202,193,1240
Gui Santos,1029483,AP,21,GSW,17,0,147,19,39,0.487,7,18,0.389,12,21,0.571,0.577,14,15,0.933,15,29,44,11,3,2,7,17,59
Marcus Sasser,2624040,BA,23,DET,54,0,876,151,333,0.453,61,154,0.396,90,179,0.503,0.545,35,41,0.854,7,78,85,161,32,8,55,76,398
Dennis Schröder,12405000,BA,30,TOT,64,42,1948,318,715,0.445,108,284,0.38,210,431,0.487,0.52,141,173,0.815,27,151,178,387,51,11,113,130,885
Alperen Sengun,3536400,P,21,HOU,62,62,2016,520,968,0.537,33,111,0.297,487,857,0.568,0.554,244,350,0.697,183,400,583,310,74,46,162,207,1317
Brice Sensabaugh,2448600,AL,20,UTA,14,2,171,27,58,0.466,10,29,0.345,17,29,0.586,0.552,8,9,0.889,5,20,25,10,4,0,16,14,72
Collin Sexton,17325000,ES,25,UTA,64,41,1626,392,812,0.483,107,265,0.404,285,547,0.521,0.549,272,316,0.861,53,108,161,300,51,13,123,125,1163
Landry Shamet,10250000,ES,26,WAS,45,5,719,118,274,0.431,53,157,0.338,65,117,0.556,0.527,38,46,0.826,16,46,62,54,25,10,30,75,327
Day'Ron Sharpe,2210160,P,22,BRK,47,1,729,135,233,0.579,4,12,0.333,131,221,0.593,0.588,65,106,0.613,126,186,312,68,21,35,50,103,339
Shaedon Sharpe,6313800,ES,20,POR,32,25,1059,176,434,0.406,60,180,0.333,116,254,0.457,0.475,98,119,0.824,42,118,160,94,28,12,72,88,510
Ben Sheppard,2537160,ES,22,IND,39,0,468,56,133,0.421,34,91,0.374,22,42,0.524,0.549,14,17,0.824,8,50,58,29,21,2,7,59,160
Pascal Siakam,37893408,AP,29,TOT,62,62,2107,522,979,0.533,73,215,0.34,449,764,0.588,0.57,222,300,0.74,99,308,407,289,49,18,117,147,1339
Anfernee Simons,24107143,ES,24,POR,40,40,1380,318,737,0.431,136,350,0.389,182,387,0.47,0.524,142,156,0.91,20,125,145,220,21,4,115,88,914
Marcus Smart,18583713,BA,29,MEM,20,20,605,102,237,0.43,42,134,0.313,60,103,0.583,0.519,43,56,0.768,6,47,53,86,41,5,62,53,289
Dennis Smith Jr.,2528233,BA,26,BRK,48,2,945,131,308,0.425,26,95,0.274,105,213,0.493,0.468,40,54,0.741,45,107,152,183,58,12,59,109,328
Dru Smith,1801769,ES,26,MIA,9,0,131,15,33,0.455,7,17,0.412,8,16,0.5,0.561,2,2,1.0,6,8,14,14,9,3,5,12,39
Ish Smith,3196448,BA,35,CHO,43,5,741,66,158,0.418,4,8,0.5,62,150,0.413,0.43,3,4,0.75,11,65,76,145,17,4,47,49,139
Jabari Smith Jr.,9326520,AP,20,HOU,58,58,1861,282,627,0.45,100,279,0.358,182,348,0.523,0.53,111,137,0.81,116,379,495,87,41,45,69,156,775
Jalen Smith,5043773,P,23,IND,45,13,799,183,296,0.618,48,107,0.449,135,189,0.714,0.699,53,78,0.679,74,173,247,49,11,28,37,95,467
Nick Smith Jr.,2463960,ES,19,CHO,39,0,605,90,227,0.396,51,116,0.44,39,111,0.351,0.509,11,13,0.846,17,39,56,50,8,7,32,50,242
Jeremy Sochan,5316960,AP,20,SAS,64,63,1892,289,655,0.441,60,183,0.328,229,472,0.485,0.487,97,125,0.776,116,280,396,216,48,30,120,152,735
Jaden Springer,2226360,ES,21,TOT,38,1,397,48,126,0.381,8,39,0.205,40,87,0.46,0.413,28,34,0.824,28,34,62,36,25,11,27,52,132
Lamar Stevens,2092354,AP,26,TOT,30,2,352,72,148,0.486,9,23,0.391,63,125,0.504,0.517,26,35,0.743,25,62,87,16,12,16,20,34,179
Isaiah Stewart,5266713,AP,22,DET,41,40,1266,166,349,0.476,58,156,0.372,108,193,0.56,0.559,59,79,0.747,70,210,280,68,17,32,63,93,449
Julian Strawther,2431080,AL,21,DEN,40,0,497,75,200,0.375,38,125,0.304,37,75,0.493,0.47,18,25,0.72,4,48,52,42,17,7,17,49,206
Max Strus,14487684,AL,27,CLE,60,60,1932,263,638,0.412,144,423,0.34,119,215,0.553,0.525,62,79,0.785,53,231,284,230,53,28,91,153,732
Jalen Suggs,7252200,ES,22,ORL,58,58,1543,255,554,0.46,119,303,0.393,136,251,0.542,0.568,81,107,0.757,40,149,189,149,81,34,111,165,710
Jae'Sean Tate,6500000,AL,28,HOU,54,9,910,93,198,0.47,21,69,0.304,72,129,0.558,0.523,22,32,0.688,53,122,175,57,38,10,28,122,229
Jayson Tatum,32600060,AP,25,BOS,60,60,2154,548,1158,0.473,188,500,0.376,360,658,0.547,0.554,329,397,0.829,53,454,507,293,61,34,153,122,1613
Terry Taylor,2019706,AP,24,CHI,24,0,161,17,34,0.5,2,9,0.222,15,25,0.6,0.529,2,3,0.667,15,18,33,7,4,2,7,16,38
Garrett Temple,3196448,ES,37,TOR,16,0,69,8,21,0.381,2,9,0.222,6,12,0.5,0.429,5,6,0.833,5,6,11,6,3,0,5,6,23
Dalen Terry,3350760,ES,21,CHI,41,1,405,33,84,0.393,11,46,0.239,22,38,0.579,0.458,18,28,0.643,15,52,67,50,15,8,19,52,95
Daniel Theis,2179511,P,31,TOT,47,3,811,124,234,0.53,19,52,0.365,105,182,0.577,0.571,31,43,0.721,69,116,185,48,18,39,33,108,298
Cam Thomas,2240040,ES,22,BRK,49,34,1461,374,852,0.439,101,277,0.365,273,575,0.475,0.498,185,221,0.837,18,121,139,130,36,12,87,101,1034
Amen Thompson,8809320,AL,21,HOU,44,6,865,138,275,0.502,7,50,0.14,131,225,0.582,0.515,60,93,0.645,79,169,248,102,54,31,62,101,343
Ausar Thompson,7977480,AL,21,DET,63,38,1583,232,480,0.483,21,113,0.186,211,367,0.575,0.505,71,119,0.597,129,273,402,120,68,59,84,175,556
Klay Thompson,43219440,AL,33,GSW,60,51,1779,363,858,0.423,199,522,0.381,164,336,0.488,0.539,103,112,0.92,27,178,205,131,35,28,90,108,1028
Tristan Thompson,3196448,P,32,CLE,36,0,446,61,94,0.649,0,1,0.0,61,93,0.656,0.649,13,42,0.31,59,81,140,40,8,11,23,50,135
Matisse Thybulle,10500000,AL,26,POR,60,19,1401,119,299,0.398,76,218,0.349,43,81,0.531,0.525,22,29,0.759,29,96,125,80,108,44,37,90,336
Jacob Toppin,453617,AL,23,NYK,9,0,38,5,9,0.556,1,4,0.25,4,5,0.8,0.611,2,2,1.0,3,4,7,3,0,1,1,3,13
Obi Toppin,6803012,AP,25,IND,64,28,1400,258,459,0.562,80,200,0.4,178,259,0.687,0.649,61,81,0.753,66,178,244,96,33,33,55,115,657
Karl-Anthony Towns,36016200,AP,28,MIN,60,60,1969,472,932,0.506,134,317,0.423,338,615,0.55,0.578,250,286,0.874,91,413,504,179,43,40,169,198,1328
Gary Trent Jr.,18785000,ES,25,TOR,59,29,1613,270,643,0.42,145,361,0.402,125,282,0.443,0.533,43,61,0.705,19,125,144,88,58,9,39,74,728
P.J. Tucker,11014500,AP,38,TOT,18,3,269,6,20,0.3,5,16,0.313,1,4,0.25,0.425,3,3,1.0,17,31,48,8,9,3,5,38,20
Myles Turner,20975000,P,27,IND,60,60,1633,372,712,0.522,81,244,0.332,291,468,0.622,0.579,205,261,0.785,97,328,425,76,33,105,89,190,1030
Stanley Umude,934168,ES,24,DET,18,0,204,26,57,0.456,18,34,0.529,8,23,0.348,0.614,22,24,0.917,6,27,33,9,4,6,11,31,92
Jarred Vanderbilt,4698000,AP,24,LAL,29,6,581,59,114,0.518,8,27,0.296,51,87,0.586,0.553,24,36,0.667,41,97,138,36,36,5,28,43,150
Fred VanVleet,40806300,BA,29,HOU,56,56,2059,309,756,0.409,169,443,0.381,140,313,0.447,0.521,142,166,0.855,23,185,208,448,66,47,92,128,929
Devin Vassell,5887899,ES,23,SAS,58,52,1876,421,893,0.471,145,385,0.377,276,508,0.543,0.553,143,180,0.794,27,201,228,230,61,22,90,58,1130
Sasha Vezenkov,6341464,AP,28,SAC,35,0,440,74,165,0.448,38,100,0.38,36,65,0.554,0.564,10,13,0.769,30,56,86,15,16,7,11,35,196
Gabe Vincent,10500000,BA,27,LAL,5,0,127,12,32,0.375,2,17,0.118,10,15,0.667,0.406,1,2,0.5,2,3,5,15,6,0,2,12,27
Dean Wade,5709877,AP,27,CLE,54,32,1108,96,232,0.414,79,202,0.391,17,30,0.567,0.584,20,26,0.769,37,181,218,43,40,25,20,93,291
Franz Wagner,5508720,AL,22,ORL,56,56,1855,423,885,0.478,83,278,0.299,340,607,0.56,0.525,206,243,0.848,56,253,309,219,57,24,117,128,1135
Moritz Wagner,8000000,P,26,ORL,62,1,1138,263,441,0.596,29,89,0.326,234,352,0.665,0.629,140,173,0.809,96,186,282,74,31,18,75,131,695
Ish Wainright,853149,AL,29,POR,7,0,46,6,18,0.333,6,16,0.375,0,2,0.0,0.5,2,2,1.0,0,9,9,0,2,1,1,4,20
Jabari Walker,1719864,AL,21,POR,57,15,1260,179,382,0.469,28,106,0.264,151,276,0.547,0.505,96,125,0.768,116,252,368,50,35,21,53,133,482
Jarace Walker,6059520,AP,20,IND,22,0,224,32,80,0.4,15,39,0.385,17,41,0.415,0.494,6,7,0.857,9,34,43,28,13,9,12,21,85
Cason Wallace,5291400,ES,20,OKC,63,9,1281,160,321,0.498,72,176,0.409,88,145,0.607,0.611,23,29,0.793,40,101,141,84,49,27,30,98,415
P.J. Washington,16847826,AP,25,TOT,56,28,1668,280,630,0.444,99,311,0.318,181,319,0.567,0.523,82,115,0.713,68,228,296,114,50,41,81,134,741
Yuta Watanabe,2346614,AL,29,TOT,34,0,464,41,116,0.353,25,85,0.294,16,31,0.516,0.461,10,17,0.588,11,43,54,15,12,7,19,39,117
Trendon Watford,2019706,AP,23,BRK,46,0,536,103,197,0.523,15,42,0.357,88,155,0.568,0.561,45,51,0.882,39,84,123,55,15,12,34,73,266
Peyton Watson,2303520,AL,21,DEN,62,4,1138,163,348,0.468,41,130,0.315,122,218,0.56,0.527,59,85,0.694,40,141,181,63,35,62,46,105,426
Victor Wembanyama,12160680,P,20,SAS,56,56,1610,423,901,0.469,94,281,0.335,329,620,0.531,0.522,220,270,0.815,121,453,574,192,72,193,194,123,1160
Blake Wesley,2504640,ES,20,SAS,43,1,573,69,136,0.507,5,32,0.156,64,104,0.615,0.526,32,50,0.64,11,43,54,118,22,7,34,66,175
Russell Westbrook,3835738,BA,35,LAC,58,10,1313,257,569,0.452,37,138,0.268,220,431,0.51,0.484,90,133,0.677,80,214,294,256,65,21,118,103,641
Coby White,12444444,BA,23,CHI,64,64,2361,447,980,0.456,184,471,0.391,263,509,0.517,0.55,182,217,0.839,35,270,305,340,45,15,142,152,1260
Derrick White,18107143,ES,29,BOS,59,59,1900,311,662,0.47,151,380,0.397,160,282,0.567,0.584,115,128,0.898,40,197,237,296,60,73,94,122,888
Cam Whitmore,3218160,AL,19,HOU,37,1,658,166,356,0.466,59,164,0.36,107,192,0.557,0.549,59,88,0.67,33,110,143,18,23,11,36,49,450
Aaron Wiggins,1836096,ES,25,OKC,60,0,878,145,254,0.571,47,95,0.495,98,159,0.616,0.663,36,46,0.783,46,95,141,52,34,12,36,70,373
Andrew Wiggins,24330357,AL,28,GSW,54,42,1443,258,570,0.453,61,175,0.349,197,395,0.499,0.506,95,130,0.731,81,146,227,93,32,27,64,118,672
Lindell Wigginton,244502,BA,25,MIL,3,0,8,2,5,0.4,0,2,0.0,2,3,0.667,0.4,2,2,1.0,0,0,0,0,0,0,1,1,6
Grant Williams,12405000,AP,25,TOT,60,36,1643,188,435,0.432,99,266,0.372,89,169,0.527,0.546,72,96,0.75,66,172,238,113,33,33,78,176,547
Jalen Williams,4558680,AP,22,OKC,57,57,1820,429,796,0.539,87,193,0.451,342,603,0.567,0.594,152,186,0.817,30,201,231,257,61,30,98,152,1097
Jaylin Williams,2000000,P,21,OKC,51,0,645,67,168,0.399,39,106,0.368,28,62,0.452,0.515,23,28,0.821,29,139,168,67,21,19,20,73,196
Kenrich Williams,6175000,AP,29,OKC,51,1,726,84,187,0.449,39,101,0.386,45,86,0.523,0.553,3,10,0.3,37,104,141,62,25,6,20,69,210
Patrick Williams,9835881,AP,22,CHI,43,30,1174,159,359,0.443,59,148,0.399,100,211,0.474,0.525,52,66,0.788,46,120,166,66,40,33,57,87,429
Vince Williams Jr.,2486462,ES,23,MEM,52,33,1436,169,379,0.446,79,209,0.378,90,170,0.529,0.55,104,130,0.8,59,231,290,175,47,34,92,135,521
Ziaire Williams,4810200,AL,22,MEM,51,15,1038,150,378,0.397,58,189,0.307,92,189,0.487,0.474,62,75,0.827,35,145,180,75,36,9,66,85,420
Zion Williamson,34005250,AP,23,NOP,52,52,1591,451,785,0.575,5,14,0.357,446,771,0.578,0.578,239,344,0.695,91,202,293,268,47,31,132,118,1146
Jalen Wilson,707770,AP,23,BRK,26,1,374,41,99,0.414,15,42,0.357,26,57,0.456,0.49,21,23,0.913,31,39,70,29,7,1,9,30,118
James Wiseman,12119440,P,22,DET,44,0,647,119,178,0.669,0,2,0.0,119,176,0.676,0.669,34,55,0.618,69,122,191,32,8,26,37,96,272
Christian Wood,2709849,AP,28,LAL,50,1,872,123,264,0.466,35,114,0.307,88,150,0.587,0.532,66,94,0.702,39,215,254,49,16,33,50,72,347
Delon Wright,947205,BA,31,TOT,36,1,512,52,131,0.397,16,42,0.381,36,89,0.404,0.458,29,35,0.829,14,49,63,91,38,9,11,23,149
Thaddeus Young,1010371,AP,35,TOT,25,6,379,57,93,0.613,1,6,0.167,56,87,0.644,0.618,5,14,0.357,36,49,85,50,19,3,12,42,120
Trae Young,40064220,BA,25,ATL,51,51,1862,418,982,0.426,169,456,0.371,249,526,0.473,0.512,339,396,0.856,22,118,140,553,70,11,220,106,1344
Omer Yurtseven,2800000,P,25,UTA,35,6,317,49,94,0.521,4,17,0.235,45,77,0.584,0.543,8,15,0.533,45,81,126,16,5,14,25,39,110
Cody Zeller,3196448,P,31,NOP,39,0,301,25,60,0.417,1,3,0.333,24,57,0.421,0.425,22,36,0.611,46,61,107,36,8,5,15,42,73
