Player,Pos,Age,Tm,G,GS,MP,FG,FGA,FG%,3P,3PA,3P%,2P,2PA,2P%,eFG%,FT,FTA,FT%,ORB,DRB,TRB,AST,STL,BLK,TOV,PF,PTS
Precious Achiuwa,,24,TOT,55,16,1237,189,375,0.504,21,81,0.259,168,294,0.571,0.532,54,87,0.621,147,212,359,74,36,47,60,105,453
Bam Adebayo,P,26,MIA,51,51,1766,397,770,0.516,1,12,0.083,396,758,0.522,0.516,243,313,0.776,112,415,527,205,53,49,125,126,1038
Ochai Agbaji,ES,23,TOT,61,12,1162,129,310,0.416,55,172,0.32,74,138,0.536,0.505,21,28,0.75,45,105,150,55,30,33,42,79,334
Santi Aldama,AP,23,MEM,51,25,1303,205,478,0.429,87,252,0.345,118,226,0.522,0.52,41,67,0.612,61,224,285,115,33,38,62,75,538
Nickeil Alexander-Walker,ES,25,MIN,62,17,1425,161,377,0.427,91,241,0.378,70,136,0.515,0.548,35,45,0.778,24,97,121,159,49,34,58,111,448
Grayson Allen,ES,28,PHO,56,56,1871,239,483,0.495,146,310,0.471,93,173,0.538,0.646,97,109,0.89,36,183,219,174,50,36,72,122,721
Jarrett Allen,P,25,CLE,57,57,1790,372,589,0.632,0,5,0.0,372,584,0.637,0.632,163,222,0.734,193,413,606,156,42,65,96,119,907
Jose Alvarado,BA,25,NOP,41,0,702,104,251,0.414,51,145,0.352,53,106,0.5,0.516,27,40,0.675,16,74,90,84,47,14,33,60,286
Kyle Anderson,AP,30,MIN,60,4,1319,145,309,0.469,8,37,0.216,137,272,0.504,0.482,76,106,0.717,45,166,211,244,49,32,75,89,374
Giannis Antetokounmpo,AP,29,MIL,60,60,2093,687,1112,0.618,32,106,0.302,655,1006,0.651,0.632,436,660,0.661,153,519,672,378,75,61,202,173,1842
Thanasis Antetokounmpo,AP,31,MIL,27,0,126,12,24,0.5,0,1,0.0,12,23,0.522,0.5,0,2,0.0,6,4,10,13,5,4,11,21,24
Cole Anthony,BA,23,ORL,62,0,1423,255,590,0.432,65,204,0.319,190,386,0.492,0.487,155,186,0.833,51,200,251,189,52,27,105,152,730
OG Anunoby,AL,26,TOT,41,41,1400,238,478,0.498,86,227,0.379,152,251,0.606,0.588,65,84,0.774,39,132,171,93,53,28,62,96,627
Ryan Arcidiacono,BA,29,NYK,20,0,45,0,6,0.0,0,6,0.0,0,0,,0.0,0,0,,0,8,8,4,2,0,2,5,0
Deni Avdija,AL,23,WAS,59,59,1688,298,592,0.503,69,173,0.399,229,419,0.547,0.562,142,190,0.747,65,331,396,221,48,24,120,148,807
Deandre Ayton,P,25,POR,40,40,1263,265,465,0.57,0,0,,265,465,0.57,0.57,42,51,0.824,121,302,423,69,42,31,69,89,572
Udoka Azubuike,P,24,PHO,14,0,107,16,22,0.727,0,0,,16,22,0.727,0.727,3,11,0.273,11,21,32,3,1,6,4,17,35
Ibou Badji,P,21,POR,18,1,203,12,19,0.632,0,0,,12,19,0.632,0.632,5,10,0.5,19,29,48,13,2,20,14,42,29
Marvin Bagley III,P,24,TOT,44,22,932,207,360,0.575,5,17,0.294,202,343,0.589,0.582,89,119,0.748,119,153,272,54,17,28,53,77,508
Amari Bailey,BA,19,CHO,3,0,15,2,7,0.286,0,3,0.0,2,4,0.5,0.286,1,2,0.5,2,0,2,1,0,0,1,0,5
Patrick Baldwin Jr.,AL,21,WAS,20,0,152,18,47,0.383,11,27,0.407,7,20,0.35,0.5,8,12,0.667,7,36,43,8,2,4,6,22,55
LaMelo Ball,BA,22,CHO,22,22,711,183,423,0.433,70,197,0.355,113,226,0.5,0.515,90,104,0.865,29,84,113,176,40,4,83,79,526
Mo Bamba,P,25,PHI,40,3,439,61,130,0.469,14,33,0.424,47,97,0.485,0.523,21,33,0.636,56,95,151,28,13,38,29,62,157
Paolo Banchero,AP,21,ORL,61,61,2125,499,1079,0.462,92,254,0.362,407,825,0.493,0.505,307,434,0.707,67,349,416,320,59,32,188,120,1397
Desmond Bane,ES,25,MEM,37,37,1277,330,696,0.474,123,320,0.384,207,376,0.551,0.563,121,140,0.864,34,135,169,196,38,20,99,106,904
Dalano Banton,BA,24,TOT,34,3,369,61,150,0.407,12,49,0.245,49,101,0.485,0.447,35,50,0.7,25,49,74,41,10,7,23,34,169
Dominick Barlow,AP,20,SAS,24,1,307,40,84,0.476,3,7,0.429,37,77,0.481,0.494,22,34,0.647,33,51,84,26,9,12,5,33,105
Harrison Barnes,AP,31,SAC,61,61,1785,257,528,0.487,115,289,0.398,142,239,0.594,0.596,110,137,0.803,48,126,174,68,43,10,43,77,739
Scottie Barnes,ES,22,TOR,60,60,2094,447,942,0.475,101,296,0.341,346,646,0.536,0.528,196,251,0.781,141,353,494,363,75,88,165,118,1191
RJ Barrett,ES,23,TOT,51,51,1600,366,752,0.487,82,226,0.363,284,526,0.54,0.541,173,246,0.703,43,227,270,158,27,19,102,109,987
Charles Bassey,P,23,SAS,19,0,205,29,40,0.725,0,1,0.0,29,39,0.744,0.725,5,6,0.833,23,53,76,21,8,17,15,31,63
Emoni Bates,AL,20,CLE,10,0,76,6,25,0.24,5,20,0.25,1,5,0.2,0.34,1,2,0.5,1,9,10,6,1,2,1,5,18
Keita Bates-Diop,AL,28,TOT,47,8,644,71,162,0.438,21,69,0.304,50,93,0.538,0.503,30,40,0.75,30,75,105,36,23,22,15,34,193
Nicolas Batum,AP,35,TOT,42,30,1022,82,171,0.48,51,121,0.421,31,50,0.62,0.629,14,19,0.737,52,114,166,90,29,30,26,84,229
Darius Bazley,AP,23,PHI,3,0,10,0,1,0.0,0,0,,0,1,0.0,0.0,0,0,,0,1,1,2,0,0,1,0,0
Bradley Beal,ES,30,PHO,33,33,1069,233,470,0.496,55,146,0.377,178,324,0.549,0.554,79,101,0.782,29,111,140,149,29,9,84,84,600
Malik Beasley,ES,27,MIL,61,61,1802,248,541,0.458,175,402,0.435,73,139,0.525,0.62,17,27,0.63,38,197,235,86,52,7,42,126,688
MarJon Beauchamp,AL,23,MIL,45,1,589,74,155,0.477,28,71,0.394,46,84,0.548,0.568,19,28,0.679,22,74,96,30,12,6,27,52,195
Jules Bernard,ES,24,WAS,8,0,36,4,13,0.308,2,9,0.222,2,4,0.5,0.385,1,2,0.5,3,3,6,5,1,1,2,4,11
Dāvis Bertāns,AP,31,TOT,24,0,235,39,89,0.438,36,82,0.439,3,7,0.429,0.64,16,18,0.889,2,21,23,14,6,5,2,21,130
Patrick Beverley,BA,35,TOT,58,6,1120,127,301,0.422,47,140,0.336,80,161,0.497,0.5,59,73,0.808,40,144,184,169,34,24,59,100,360
Saddiq Bey,AL,24,ATL,61,49,1997,286,674,0.424,110,344,0.32,176,330,0.533,0.506,164,195,0.841,162,235,397,88,50,10,51,86,846
Goga Bitadze,P,24,ORL,51,33,899,117,193,0.606,2,12,0.167,115,181,0.635,0.611,52,79,0.658,103,167,270,75,30,70,39,101,288
Onuralp Bitim,ES,24,CHI,6,0,69,5,17,0.294,4,11,0.364,1,6,0.167,0.412,3,4,0.75,1,10,11,2,0,1,3,5,17
Bismack Biyombo,P,31,TOT,34,27,741,68,123,0.553,0,0,,68,123,0.553,0.553,22,46,0.478,59,136,195,52,10,35,39,87,158
Anthony Black,BA,20,ORL,57,32,1054,104,219,0.475,34,83,0.41,70,136,0.515,0.553,48,75,0.64,31,100,131,86,32,18,50,102,290
Leaky Black,AL,24,CHO,22,3,218,17,39,0.436,7,15,0.467,10,24,0.417,0.526,9,14,0.643,8,30,38,18,5,6,5,15,50
Bogdan Bogdanović,ES,31,ATL,60,14,1764,354,831,0.426,182,494,0.368,172,337,0.51,0.535,108,117,0.923,35,162,197,172,75,17,77,136,998
Bojan Bogdanović,,34,TOT,37,27,1150,244,533,0.458,108,267,0.404,136,266,0.511,0.559,101,128,0.789,17,105,122,82,28,5,76,80,697
Bol Bol,AP,24,PHO,24,0,265,54,90,0.6,8,27,0.296,46,63,0.73,0.644,7,10,0.7,23,57,80,11,5,16,11,30,123
Marques Bolden,P,25,TOT,4,0,16,0,1,0.0,0,0,,0,1,0.0,0.0,0,0,,0,3,3,0,0,0,1,2,0
Devin Booker,BA,27,PHO,50,50,1788,480,971,0.494,110,290,0.379,370,681,0.543,0.551,307,349,0.88,35,194,229,342,47,20,129,151,1377
Brandon Boston Jr.,AL,22,LAC,19,0,129,27,64,0.422,6,20,0.3,21,44,0.477,0.469,12,14,0.857,7,8,15,5,2,2,7,17,72
Chris Boucher,AP,31,TOR,48,0,650,101,206,0.49,29,91,0.319,72,115,0.626,0.561,64,85,0.753,56,134,190,19,14,21,23,64,295
James Bouknight,ES,23,CHO,14,0,81,18,41,0.439,13,30,0.433,5,11,0.455,0.598,1,2,0.5,1,8,9,6,1,1,2,3,50
Jamaree Bouyea,BA,24,POR,6,0,57,5,21,0.238,0,8,0.0,5,13,0.385,0.238,0,0,,2,8,10,8,0,0,8,3,10
Malaki Branham,BA,20,SAS,57,22,1173,198,454,0.436,62,185,0.335,136,269,0.506,0.504,36,38,0.947,20,94,114,126,21,6,64,70,494
Christian Braun,ES,22,DEN,62,1,1192,154,351,0.439,39,113,0.345,115,238,0.483,0.494,74,105,0.705,54,166,220,85,29,27,41,96,421
Mikal Bridges,AL,27,BRK,62,62,2181,460,1037,0.444,156,437,0.357,304,600,0.507,0.519,227,279,0.814,51,249,300,228,60,25,131,94,1303
Miles Bridges,AL,25,CHO,51,49,1905,412,901,0.457,123,334,0.368,289,567,0.51,0.526,128,151,0.848,50,328,378,166,54,26,104,95,1075
Oshae Brissett,AL,25,BOS,40,0,427,50,110,0.455,12,43,0.279,38,67,0.567,0.509,36,55,0.655,37,73,110,31,16,4,13,39,148
Izaiah Brockington,BA,24,NOP,1,0,3,2,5,0.4,0,1,0.0,2,4,0.5,0.4,0,0,,1,1,2,0,0,0,0,0,4
Malcolm Brogdon,BA,31,POR,39,25,1121,218,496,0.44,82,199,0.412,136,297,0.458,0.522,95,116,0.819,28,120,148,214,27,8,60,58,613
Armoni Brooks,BA,25,BRK,10,0,104,15,46,0.326,11,32,0.344,4,14,0.286,0.446,1,2,0.5,7,11,18,5,1,1,3,3,42
Dillon Brooks,AL,28,HOU,53,53,1670,250,574,0.436,101,267,0.378,149,307,0.485,0.524,96,115,0.835,43,146,189,89,48,7,67,180,697
Bruce Brown,,27,TOT,52,38,1463,212,458,0.463,42,138,0.304,170,320,0.531,0.509,95,110,0.864,43,188,231,142,48,16,59,118,561
Charlie Brown Jr.,ES,26,NYK,7,0,36,2,10,0.2,2,7,0.286,0,3,0.0,0.3,0,0,,1,1,2,0,0,2,2,5,6
Greg Brown III,AP,22,DAL,6,0,40,5,11,0.455,1,3,0.333,4,8,0.5,0.5,4,9,0.444,3,6,9,4,0,4,4,5,15
Jaylen Brown,AL,27,BOS,56,56,1863,487,974,0.5,114,322,0.354,373,652,0.572,0.559,168,233,0.721,60,245,305,208,59,29,132,149,1256
Kendall Brown,ES,20,IND,8,0,28,3,6,0.5,0,1,0.0,3,5,0.6,0.5,4,6,0.667,2,0,2,2,0,0,0,4,10
Kobe Brown,AP,24,LAC,33,0,285,24,63,0.381,12,39,0.308,12,24,0.5,0.476,1,2,0.5,10,35,45,17,6,3,7,41,61
Moses Brown,P,24,POR,12,4,104,13,25,0.52,0,0,,13,25,0.52,0.52,1,7,0.143,19,31,50,4,2,4,6,15,27
Troy Brown Jr.,AL,24,TOT,43,3,493,61,143,0.427,36,99,0.364,25,44,0.568,0.552,21,24,0.875,16,72,88,41,9,2,21,31,179
Jalen Brunson,BA,27,NYK,57,57,2019,550,1154,0.477,150,369,0.407,400,785,0.51,0.542,301,356,0.846,32,178,210,374,53,11,142,114,1551
Thomas Bryant,P,26,MIA,26,3,264,44,78,0.564,0,5,0.0,44,73,0.603,0.564,18,22,0.818,25,52,77,15,6,7,15,26,106
Kobe Bufkin,ES,20,ATL,9,0,89,13,37,0.351,5,17,0.294,8,20,0.4,0.419,2,4,0.5,2,12,14,15,3,1,5,6,33
Reggie Bullock,AL,32,HOU,26,0,226,21,52,0.404,16,41,0.39,5,11,0.455,0.558,1,1,1.0,3,32,35,10,4,2,6,15,59
Alec Burks,ES,32,TOT,53,1,1067,191,502,0.38,113,294,0.384,78,208,0.375,0.493,132,151,0.874,21,107,128,77,23,12,41,71,627
Jared Butler,ES,23,WAS,22,0,178,35,64,0.547,10,28,0.357,25,36,0.694,0.625,14,17,0.824,2,13,15,43,9,2,15,19,94
Jimmy Butler,AP,34,MIA,42,42,1426,288,569,0.506,44,97,0.454,244,472,0.517,0.545,301,351,0.858,84,147,231,203,60,15,71,46,921
Jamal Cain,AP,24,MIA,16,1,225,29,69,0.42,8,26,0.308,21,43,0.488,0.478,18,23,0.783,13,19,32,4,10,4,5,17,84
Kentavious Caldwell-Pope,ES,30,DEN,56,56,1781,196,440,0.445,86,217,0.396,110,223,0.493,0.543,91,99,0.919,25,109,134,133,74,26,53,107,569
Toumani Camara,AP,23,POR,58,38,1385,155,357,0.434,45,140,0.321,110,217,0.507,0.497,60,83,0.723,112,173,285,61,56,26,69,144,415
Clint Capela,P,29,ATL,54,54,1363,250,444,0.563,0,0,,250,444,0.563,0.563,96,146,0.658,249,308,557,56,29,81,49,131,596
Jevon Carter,BA,28,CHI,59,0,802,111,299,0.371,63,191,0.33,48,108,0.444,0.477,3,5,0.6,7,39,46,69,31,13,30,58,288
Wendell Carter Jr.,P,24,ORL,36,30,943,153,279,0.548,43,102,0.422,110,177,0.621,0.625,70,97,0.722,67,172,239,57,17,18,42,83,419
D.J. Carton,ES,23,TOR,4,0,36,3,8,0.375,1,4,0.25,2,4,0.5,0.438,4,5,0.8,2,2,4,3,1,0,1,3,11
Alex Caruso,ES,29,CHI,53,40,1454,181,391,0.463,91,239,0.381,90,152,0.592,0.579,59,76,0.776,48,149,197,154,82,59,71,134,512
Colin Castleton,P,23,LAL,7,0,36,7,10,0.7,0,0,,7,10,0.7,0.7,4,4,1.0,4,5,9,3,0,0,1,7,18
Malcolm Cazalon,ES,22,DET,1,0,3,0,0,,0,0,,0,0,,,0,0,,0,0,0,0,0,0,0,0,0
Julian Champagnie,AL,22,SAS,54,39,904,101,255,0.396,65,182,0.357,36,73,0.493,0.524,42,52,0.808,32,107,139,65,32,29,33,56,309
Justin Champagnie,AL,22,WAS,3,0,16,5,10,0.5,1,5,0.2,4,5,0.8,0.55,0,0,,0,1,1,1,1,1,1,0,11
Max Christie,ES,20,LAL,50,7,812,86,201,0.428,36,100,0.36,50,101,0.495,0.517,33,42,0.786,12,109,121,52,17,16,31,53,241
Sidy Cissoko,AL,19,SAS,6,0,32,1,6,0.167,0,4,0.0,1,2,0.5,0.167,4,4,1.0,0,6,6,0,3,0,1,2,6
Jordan Clarkson,ES,31,UTA,52,19,1588,317,773,0.41,89,299,0.298,228,474,0.481,0.468,172,195,0.882,48,132,180,264,31,6,137,76,895
Nic Claxton,P,24,BRK,52,52,1533,274,437,0.627,1,4,0.25,273,433,0.63,0.628,80,138,0.58,139,372,511,103,33,112,62,130,629
Noah Clowney,AP,19,BRK,7,0,69,11,18,0.611,1,4,0.25,10,14,0.714,0.639,6,6,1.0,6,7,13,6,0,1,3,5,29
Amir Coffey,AL,26,LAC,49,9,920,105,202,0.52,40,97,0.412,65,105,0.619,0.619,45,51,0.882,18,66,84,45,28,7,21,65,295
John Collins,AP,26,UTA,59,57,1663,340,647,0.526,70,207,0.338,270,440,0.614,0.58,109,139,0.784,137,371,508,70,34,56,86,167,859
Zach Collins,P,26,SAS,50,24,1157,217,451,0.481,43,144,0.299,174,307,0.567,0.529,85,115,0.739,86,179,265,151,24,35,101,152,562
Mike Conley,BA,36,MIN,57,57,1643,203,456,0.445,128,292,0.438,75,164,0.457,0.586,71,78,0.91,25,141,166,355,60,12,67,94,605
Pat Connaughton,AL,31,MIL,57,2,1223,110,241,0.456,64,169,0.379,46,72,0.639,0.589,26,36,0.722,35,147,182,109,32,14,36,71,310
Bilal Coulibaly,AL,19,WAS,58,10,1555,169,387,0.437,56,160,0.35,113,227,0.498,0.509,80,115,0.696,50,182,232,99,49,44,80,125,474
Ricky Council IV,ES,22,PHI,20,0,189,37,79,0.468,4,19,0.211,33,60,0.55,0.494,42,58,0.724,12,27,39,7,2,0,4,9,120
Robert Covington,,33,TOT,29,6,488,43,98,0.439,19,56,0.339,24,42,0.571,0.536,22,26,0.846,31,66,97,24,39,18,11,56,127
Torrey Craig,AL,33,CHI,33,8,694,71,167,0.425,37,99,0.374,34,68,0.5,0.536,21,27,0.778,55,101,156,36,20,15,19,75,200
Jae Crowder,AP,33,MIL,32,16,783,73,172,0.424,38,109,0.349,35,63,0.556,0.535,16,24,0.667,17,100,117,48,27,6,16,54,200
Jalen Crutcher,BA,24,NOP,1,0,3,0,1,0.0,0,0,,0,1,0.0,0.0,0,0,,0,0,0,0,0,0,0,0,0
Cade Cunningham,BA,22,DET,51,51,1723,422,933,0.452,98,272,0.36,324,661,0.49,0.505,190,221,0.86,23,187,210,378,45,19,176,135,1132
Seth Curry,ES,33,TOT,44,4,616,80,204,0.392,38,108,0.352,42,96,0.438,0.485,28,31,0.903,18,50,68,44,22,6,21,39,226
Stephen Curry,BA,35,GSW,58,58,1907,518,1146,0.452,287,701,0.409,231,445,0.519,0.577,252,274,0.92,30,224,254,290,46,21,174,99,1575
Dyson Daniels,BA,20,NOP,52,15,1139,112,256,0.438,32,110,0.291,80,146,0.548,0.5,32,50,0.64,51,140,191,136,72,21,52,84,288
Anthony Davis,P,30,LAL,60,60,2142,566,1017,0.557,19,73,0.26,547,944,0.579,0.566,335,411,0.815,181,554,735,216,66,146,121,143,1486
Johnny Davis,ES,21,WAS,31,0,308,31,89,0.348,5,18,0.278,26,71,0.366,0.376,6,11,0.545,13,28,41,13,10,2,7,25,73
JD Davison,ES,21,BOS,2,0,6,0,1,0.0,0,1,0.0,0,0,,0.0,2,2,1.0,1,1,2,0,0,0,0,0,2
Dexter Dennis,ES,24,DAL,4,0,30,10,19,0.526,1,8,0.125,9,11,0.818,0.553,1,3,0.333,1,8,9,4,0,1,3,1,22
DeMar DeRozan,AL,34,CHI,60,60,2269,470,998,0.471,58,169,0.343,412,829,0.497,0.5,381,442,0.862,36,213,249,319,66,35,88,130,1379
Moussa Diabaté,P,22,LAC,11,0,64,10,19,0.526,0,0,,10,19,0.526,0.526,9,14,0.643,15,9,24,4,5,1,2,4,29
Mamadi Diakite,AP,27,SAS,3,0,16,4,5,0.8,0,0,,4,5,0.8,0.8,4,6,0.667,1,2,3,2,0,1,0,1,12
Hamidou Diallo,ES,25,WAS,2,0,5,1,2,0.5,0,0,,1,2,0.5,0.5,0,0,,2,0,2,1,2,0,1,1,2
Gradey Dick,ES,20,TOR,41,1,677,95,218,0.436,48,129,0.372,47,89,0.528,0.546,23,25,0.92,19,59,78,45,22,0,25,55,261
Ousmane Dieng,AP,20,OKC,29,0,326,43,101,0.426,20,64,0.313,23,37,0.622,0.525,14,16,0.875,10,39,49,31,5,3,16,19,120
Spencer Dinwiddie,BA,30,TOT,58,48,1713,214,550,0.389,99,310,0.319,115,240,0.479,0.479,131,169,0.775,27,141,168,321,42,11,73,103,658
Donte DiVincenzo,ES,27,NYK,61,43,1596,311,698,0.446,197,485,0.406,114,213,0.535,0.587,55,76,0.724,49,159,208,154,75,23,78,120,874
Luka Dončić,BA,24,DAL,54,54,2028,637,1284,0.496,209,553,0.378,428,731,0.585,0.577,386,492,0.785,42,442,484,527,78,31,212,114,1869
Luguentz Dort,AL,24,OKC,60,60,1706,218,496,0.44,120,295,0.407,98,201,0.488,0.56,86,105,0.819,62,161,223,78,54,41,52,181,642
Ayo Dosunmu,ES,24,CHI,60,21,1627,250,509,0.491,87,218,0.399,163,291,0.56,0.577,57,73,0.781,41,121,162,168,51,26,72,122,644
Jeff Dowtin,BA,26,PHI,2,0,30,4,7,0.571,2,4,0.5,2,3,0.667,0.714,0,0,,0,3,3,7,3,1,1,0,10
Andre Drummond,P,30,CHI,62,10,1072,215,389,0.553,0,3,0.0,215,386,0.557,0.553,92,160,0.575,211,339,550,30,61,41,67,113,522
Chris Duarte,AL,26,SAC,43,11,569,60,156,0.385,32,90,0.356,28,66,0.424,0.487,21,27,0.778,19,64,83,35,23,5,20,67,173
Kris Dunn,BA,29,UTA,55,28,1014,124,256,0.484,35,90,0.389,89,166,0.536,0.553,17,25,0.68,41,114,155,219,59,23,71,105,300
Kevin Durant,AP,35,PHO,55,55,2051,557,1063,0.524,120,286,0.42,437,777,0.562,0.58,301,352,0.855,31,337,368,304,48,73,181,100,1535
Jalen Duren,P,20,DET,46,45,1385,273,436,0.626,0,3,0.0,273,433,0.63,0.626,94,122,0.77,151,390,541,119,21,40,91,154,640
Tari Eason,AP,22,HOU,22,0,480,88,189,0.466,18,50,0.36,70,139,0.504,0.513,21,33,0.636,46,107,153,27,31,19,20,51,215
Anthony Edwards,ES,22,MIN,59,58,2057,533,1146,0.465,149,394,0.378,384,752,0.511,0.53,326,387,0.842,31,276,307,300,74,30,186,110,1541
Kessler Edwards,AL,23,SAC,39,0,189,21,53,0.396,12,33,0.364,9,20,0.45,0.509,4,6,0.667,5,25,30,9,4,4,1,18,58
Keon Ellis,ES,24,SAC,36,4,419,41,98,0.418,28,77,0.364,13,21,0.619,0.561,11,17,0.647,14,34,48,46,19,14,19,52,121
Joel Embiid,P,29,PHI,34,34,1157,402,754,0.533,41,112,0.366,361,642,0.562,0.56,356,403,0.883,89,295,384,193,39,60,126,98,1201
Drew Eubanks,P,26,PHO,56,4,891,123,197,0.624,3,3,1.0,120,194,0.619,0.632,61,80,0.763,74,164,238,50,21,48,52,89,310
Tosan Evbuomwan,AL,22,TOT,6,0,90,7,18,0.389,3,9,0.333,4,9,0.444,0.472,0,0,,8,8,16,6,1,1,1,6,17
Dante Exum,BA,28,DAL,36,14,686,119,211,0.564,32,67,0.478,87,144,0.604,0.64,38,52,0.731,18,78,96,99,19,5,28,56,308
Bruno Fernando,P,25,ATL,25,1,294,48,86,0.558,0,3,0.0,48,83,0.578,0.558,26,42,0.619,30,58,88,16,10,16,18,43,122
Dorian Finney-Smith,AP,30,BRK,53,42,1486,174,408,0.426,102,271,0.376,72,137,0.526,0.551,19,28,0.679,91,161,252,83,38,31,47,122,469
Adam Flagler,ES,24,OKC,1,0,6,0,3,0.0,0,3,0.0,0,0,,0.0,0,0,,0,0,0,1,0,0,0,0,0
Malachi Flynn,BA,25,TOT,52,0,601,76,192,0.396,36,106,0.34,40,86,0.465,0.49,28,37,0.757,13,67,80,88,22,6,41,50,216
Simone Fontecchio,AL,28,TOT,60,39,1444,217,478,0.454,118,298,0.396,99,180,0.55,0.577,43,54,0.796,58,152,210,93,40,18,60,96,595
Jordan Ford,BA,25,SAC,6,0,22,4,7,0.571,2,3,0.667,2,4,0.5,0.714,2,2,1.0,0,2,2,2,0,0,1,0,12
Trent Forrest,ES,25,ATL,24,0,242,20,54,0.37,2,7,0.286,18,47,0.383,0.389,9,12,0.75,6,24,30,49,7,1,11,21,51
Evan Fournier,ES,31,TOT,12,0,206,31,84,0.369,17,55,0.309,14,29,0.483,0.47,13,15,0.867,3,21,24,14,12,2,9,19,92
De'Aaron Fox,BA,26,SAC,53,53,1896,525,1105,0.475,148,403,0.367,377,702,0.537,0.542,238,335,0.71,48,173,221,300,101,21,144,135,1436
Javon Freeman-Liberty,BA,24,TOR,4,0,23,5,10,0.5,1,3,0.333,4,7,0.571,0.55,4,5,0.8,1,3,4,1,0,0,0,0,15
Alex Fudge,AL,20,LAL,4,0,14,1,6,0.167,0,2,0.0,1,4,0.25,0.167,2,2,1.0,2,0,2,0,0,0,1,1,4
Markelle Fultz,BA,25,ORL,26,15,595,102,206,0.495,1,9,0.111,101,197,0.513,0.498,15,25,0.6,36,53,89,84,30,9,31,39,220
Daniel Gafford,,25,TOT,55,47,1364,241,350,0.689,0,0,,241,350,0.689,0.689,98,140,0.7,157,275,432,77,50,111,55,170,580
Danilo Gallinari,,35,TOT,39,0,548,73,169,0.432,27,83,0.325,46,86,0.535,0.512,74,86,0.86,18,80,98,50,10,5,17,42,247
Darius Garland,BA,24,CLE,38,38,1251,249,553,0.45,83,223,0.372,166,330,0.503,0.525,112,133,0.842,17,72,89,237,51,4,119,59,693
Usman Garuba,AP,21,GSW,3,0,8,0,1,0.0,0,0,,0,1,0.0,0.0,0,0,,1,0,1,1,1,0,0,2,0
Luka Garza,P,25,MIN,14,0,40,11,25,0.44,3,9,0.333,8,16,0.5,0.5,8,12,0.667,6,5,11,2,0,0,2,11,33
Kaiser Gates,AL,27,NOP,1,0,7,0,4,0.0,0,2,0.0,0,2,0.0,0.0,0,0,,0,1,1,0,0,0,0,0,0
Keyonte George,BA,20,UTA,56,25,1421,218,555,0.393,109,309,0.353,109,246,0.443,0.491,125,152,0.822,14,142,156,246,27,5,117,61,670
Paul George,AP,33,LAC,56,56,1898,435,952,0.457,184,464,0.397,251,488,0.514,0.554,184,208,0.885,30,270,300,197,87,22,114,156,1238
Taj Gibson,AP,38,NYK,16,1,165,7,23,0.304,0,6,0.0,7,17,0.412,0.304,2,2,1.0,10,18,28,9,2,6,5,28,16
Josh Giddey,ES,21,OKC,61,61,1508,281,617,0.455,58,176,0.33,223,441,0.506,0.502,71,86,0.826,81,285,366,268,42,34,124,80,691
Harry Giles,P,25,TOT,18,0,85,22,45,0.489,3,12,0.25,19,33,0.576,0.522,7,13,0.538,12,15,27,6,1,3,6,15,54
Shai Gilgeous-Alexander,BA,25,OKC,61,61,2102,671,1228,0.546,77,204,0.377,594,1024,0.58,0.578,481,545,0.883,53,288,341,394,130,58,133,155,1900
Anthony Gill,AP,31,WAS,32,0,173,23,50,0.46,3,13,0.231,20,37,0.541,0.49,15,20,0.75,14,25,39,14,7,6,15,12,64
Collin Gillespie,BA,24,DEN,19,0,161,23,45,0.511,11,24,0.458,12,21,0.571,0.633,5,8,0.625,1,11,12,16,10,0,10,18,62
Jacob Gilyard,BA,25,MEM,37,14,654,60,144,0.417,51,120,0.425,9,24,0.375,0.594,2,2,1.0,8,35,43,131,27,5,29,35,173
Rudy Gobert,P,31,MIN,60,60,2027,315,483,0.652,0,3,0.0,315,480,0.656,0.652,198,306,0.647,217,552,769,73,35,128,92,185,828
Jordan Goodwin,BA,25,TOT,45,4,706,91,240,0.379,27,95,0.284,64,145,0.441,0.435,29,39,0.744,50,93,143,102,33,15,39,50,238
Aaron Gordon,AP,28,DEN,56,56,1768,307,557,0.551,31,106,0.292,276,451,0.612,0.579,132,203,0.65,134,230,364,180,47,37,82,105,777
Eric Gordon,ES,35,PHO,51,24,1512,230,510,0.451,124,323,0.384,106,187,0.567,0.573,46,58,0.793,15,89,104,114,49,25,64,62,630
Devonte' Graham,BA,28,SAS,12,0,99,11,30,0.367,7,22,0.318,4,8,0.5,0.483,6,8,0.75,2,14,16,19,3,1,3,4,35
Jerami Grant,AP,29,POR,53,53,1795,378,836,0.452,110,272,0.404,268,564,0.475,0.518,252,309,0.816,37,152,189,150,43,34,114,117,1118
A.J. Green,ES,24,MIL,42,0,401,61,141,0.433,50,122,0.41,11,19,0.579,0.61,10,11,0.909,6,39,45,26,3,2,7,36,182
Danny Green,ES,36,PHI,2,0,18,0,2,0.0,0,1,0.0,0,1,0.0,0.0,0,0,,0,2,2,1,1,0,0,1,0
Draymond Green,AP,33,GSW,37,34,973,127,252,0.504,39,87,0.448,88,165,0.533,0.581,45,59,0.763,46,213,259,216,27,34,88,110,338
Jalen Green,ES,21,HOU,62,62,1905,393,960,0.409,132,422,0.313,261,538,0.485,0.478,211,260,0.812,27,273,300,206,46,20,137,82,1129
Jeff Green,AP,37,HOU,59,5,966,113,242,0.467,27,88,0.307,86,154,0.558,0.523,98,121,0.81,34,91,125,51,10,26,40,82,351
Josh Green,ES,23,DAL,49,32,1340,164,336,0.488,69,169,0.408,95,167,0.569,0.591,33,50,0.66,35,128,163,118,42,8,55,98,430
AJ Griffin,AL,20,ATL,18,0,132,13,45,0.289,9,33,0.273,4,12,0.333,0.389,2,2,1.0,2,12,14,4,1,1,6,6,37
Quentin Grimes,ES,23,TOT,49,18,989,120,314,0.382,81,231,0.351,39,83,0.47,0.511,27,37,0.73,14,82,96,60,34,7,26,70,348
Mouhamadou Gueye,AP,25,TOR,2,0,10,1,4,0.25,0,0,,1,4,0.25,0.25,0,0,,3,2,5,0,0,3,0,2,2
Mouhamed Gueye,AP,21,ATL,2,0,4,0,1,0.0,0,1,0.0,0,0,,0.0,0,0,,0,0,0,0,1,0,0,1,0
Rui Hachimura,AP,25,LAL,50,21,1264,245,467,0.525,66,159,0.415,179,308,0.581,0.595,69,97,0.711,39,147,186,51,36,16,36,73,625
Ashton Hagans,BA,24,POR,11,1,175,15,36,0.417,2,9,0.222,13,27,0.481,0.444,7,9,0.778,6,16,22,30,7,6,18,25,39
Tyrese Haliburton,BA,23,IND,50,49,1597,374,778,0.481,148,391,0.379,226,387,0.584,0.576,142,167,0.85,30,161,191,567,53,33,114,47,1038
R.J. Hampton,BA,22,MIA,8,2,76,4,14,0.286,1,8,0.125,3,6,0.5,0.321,1,2,0.5,2,4,6,8,0,0,3,8,10
Tim Hardaway Jr.,AL,31,DAL,59,10,1699,329,806,0.408,176,490,0.359,153,316,0.484,0.517,126,144,0.875,19,188,207,98,29,5,57,89,960
James Harden,BA,34,LAC,56,56,1940,289,647,0.447,156,382,0.408,133,265,0.502,0.567,255,290,0.879,25,259,284,463,61,52,145,107,989
Jaden Hardy,ES,21,DAL,55,6,803,157,388,0.405,70,192,0.365,87,196,0.444,0.495,40,55,0.727,15,86,101,86,17,4,40,58,424
Ron Harper Jr.,AP,23,TOR,1,0,4,0,0,,0,0,,0,0,,,0,0,,0,0,0,1,0,0,0,2,0
Gary Harris,ES,29,ORL,39,12,894,99,216,0.458,56,147,0.381,43,69,0.623,0.588,28,37,0.757,18,47,65,68,37,11,20,68,282
Joe Harris,ES,32,DET,16,0,170,14,39,0.359,10,30,0.333,4,9,0.444,0.487,1,2,0.5,3,10,13,10,3,2,4,19,39
Kevon Harris,ES,26,ORL,2,0,6,2,3,0.667,0,0,,2,3,0.667,0.667,0,0,,0,2,2,1,0,0,1,3,4
Tobias Harris,AP,31,PHI,56,56,1898,376,758,0.496,70,198,0.354,306,560,0.546,0.542,157,176,0.892,61,283,344,180,56,31,76,95,979
Shaquille Harrison,ES,30,MEM,3,0,6,1,2,0.5,0,0,,1,2,0.5,0.5,0,0,,0,2,2,0,0,1,0,0,2
Josh Hart,AL,28,NYK,61,22,1917,204,481,0.424,66,201,0.328,138,280,0.493,0.493,61,80,0.763,86,379,465,217,52,20,82,118,535
Isaiah Hartenstein,P,25,NYK,56,30,1404,154,255,0.604,1,3,0.333,153,252,0.607,0.606,79,109,0.725,186,284,470,121,61,60,65,156,388
Sam Hauser,AL,26,BOS,60,6,1257,163,365,0.447,131,315,0.416,32,50,0.64,0.626,15,17,0.882,36,168,204,55,23,16,28,80,472
Jordan Hawkins,ES,21,NOP,55,10,1075,167,428,0.39,104,281,0.37,63,147,0.429,0.512,64,75,0.853,28,113,141,65,17,6,38,68,502
Jaxson Hayes,P,23,LAL,53,3,600,83,121,0.686,0,8,0.0,83,113,0.735,0.686,29,49,0.592,46,90,136,24,26,22,25,86,195
Killian Hayes,BA,22,DET,42,31,1008,117,283,0.413,22,74,0.297,95,209,0.455,0.452,33,50,0.66,11,108,119,205,36,20,51,75,289
Gordon Hayward,AL,33,TOT,33,25,918,149,328,0.454,23,63,0.365,126,265,0.475,0.489,68,89,0.764,31,111,142,123,30,12,54,50,389
Scoot Henderson,BA,19,POR,43,16,1160,190,506,0.375,52,168,0.31,138,338,0.408,0.427,121,148,0.818,38,89,127,202,24,10,127,129,553
Taylor Hendricks,AP,20,UTA,23,6,401,51,116,0.44,23,68,0.338,28,48,0.583,0.539,9,11,0.818,27,64,91,13,14,13,17,40,134
Tyler Herro,ES,24,MIA,36,36,1209,283,648,0.437,117,293,0.399,166,355,0.468,0.527,66,79,0.835,18,173,191,158,29,3,77,51,749
Buddy Hield,,31,TOT,64,40,1732,297,675,0.44,178,454,0.392,119,221,0.538,0.572,36,42,0.857,41,167,208,201,58,34,82,136,808
Haywood Highsmith,AP,27,MIA,45,24,932,96,222,0.432,49,133,0.368,47,89,0.528,0.543,21,26,0.808,39,88,127,44,42,25,26,88,262
Nate Hinton,ES,24,HOU,11,0,58,10,20,0.5,7,11,0.636,3,9,0.333,0.675,4,5,0.8,3,9,12,6,2,2,2,10,31
D'Moi Hodge,ES,25,LAL,7,0,41,5,15,0.333,3,12,0.25,2,3,0.667,0.433,1,2,0.5,0,0,0,5,1,1,1,4,14
Aaron Holiday,BA,27,HOU,59,1,987,143,316,0.453,70,169,0.414,73,147,0.497,0.563,40,45,0.889,16,83,99,107,30,5,45,92,396
Jrue Holiday,BA,33,BOS,56,56,1854,275,571,0.482,114,256,0.445,161,315,0.511,0.581,56,68,0.824,73,243,316,271,49,41,104,92,720
Justin Holiday,ES,34,DEN,38,9,549,56,121,0.463,35,86,0.407,21,35,0.6,0.607,3,4,0.75,6,41,47,38,24,3,9,47,150
Richaun Holmes,,30,TOT,32,2,347,52,94,0.553,1,1,1.0,51,93,0.548,0.559,18,28,0.643,44,62,106,18,7,12,16,47,123
Chet Holmgren,P,21,OKC,62,62,1873,399,735,0.543,105,267,0.393,294,468,0.628,0.614,162,206,0.786,101,386,487,169,41,157,101,153,1065
Jalen Hood-Schifino,ES,20,LAL,21,0,109,10,45,0.222,2,15,0.133,8,30,0.267,0.244,12,20,0.6,2,11,13,8,3,2,9,13,34
Al Horford,P,37,BOS,51,23,1362,154,312,0.494,78,194,0.402,76,118,0.644,0.619,17,20,0.85,64,272,336,137,28,51,36,75,403
Talen Horton-Tucker,BA,23,UTA,40,11,795,145,361,0.402,45,136,0.331,100,225,0.444,0.464,72,90,0.8,20,83,103,153,36,15,55,74,407
Danuel House Jr.,AL,30,PHI,34,4,509,47,105,0.448,15,50,0.3,32,55,0.582,0.519,35,46,0.761,16,42,58,28,15,5,19,45,144
Caleb Houstan,AL,21,ORL,46,9,670,68,171,0.398,61,160,0.381,7,11,0.636,0.576,17,22,0.773,23,51,74,26,12,3,15,52,214
Jett Howard,AL,20,ORL,13,0,49,8,22,0.364,5,17,0.294,3,5,0.6,0.477,2,4,0.5,1,4,5,3,0,1,2,3,23
Kevin Huerter,ES,25,SAC,59,54,1478,241,535,0.45,120,325,0.369,121,210,0.576,0.563,36,47,0.766,37,175,212,155,38,21,49,125,638
Jay Huff,P,25,DEN,12,0,34,6,11,0.545,3,8,0.375,3,3,1.0,0.682,2,2,1.0,1,8,9,1,1,0,1,7,17
De'Andre Hunter,AL,26,ATL,38,24,1068,197,407,0.484,75,177,0.424,122,230,0.53,0.576,119,137,0.869,22,122,144,48,29,12,50,102,588
Matthew Hurt,AP,23,MEM,8,0,113,12,34,0.353,5,20,0.25,7,14,0.5,0.426,3,3,1.0,9,7,16,4,3,3,2,8,32
Bones Hyland,BA,23,LAC,23,2,303,50,140,0.357,21,72,0.292,29,68,0.426,0.432,10,12,0.833,3,16,19,44,10,2,26,30,131
Joe Ingles,AL,36,ORL,49,0,844,74,180,0.411,50,123,0.407,24,57,0.421,0.55,18,21,0.857,17,89,106,147,31,4,45,69,216
Brandon Ingram,AL,26,NOP,56,56,1857,452,918,0.492,79,220,0.359,373,698,0.534,0.535,232,288,0.806,40,240,280,325,45,33,147,128,1215
Kyrie Irving,ES,31,DAL,40,40,1373,389,794,0.49,120,286,0.42,269,508,0.53,0.565,129,144,0.896,31,174,205,201,48,18,65,75,1027
Jonathan Isaac,AP,26,ORL,42,1,620,96,196,0.49,21,68,0.309,75,128,0.586,0.543,46,65,0.708,52,125,177,19,30,47,22,44,259
Jaden Ivey,ES,21,DET,57,41,1592,300,680,0.441,84,251,0.335,216,429,0.503,0.503,174,233,0.747,69,130,199,208,39,33,134,161,858
Andre Jackson Jr.,ES,22,MIL,48,8,504,46,88,0.523,15,40,0.375,31,48,0.646,0.608,8,11,0.727,36,58,94,44,14,4,22,82,115
GG Jackson II,AP,19,MEM,30,1,621,114,271,0.421,49,134,0.366,65,137,0.474,0.511,55,78,0.705,31,75,106,22,14,17,32,34,332
Isaiah Jackson,P,22,IND,46,3,631,131,198,0.662,0,4,0.0,131,194,0.675,0.662,61,86,0.709,72,121,193,40,29,50,35,117,323
Jaren Jackson Jr.,P,24,MEM,55,55,1760,427,960,0.445,102,315,0.324,325,645,0.504,0.498,286,350,0.817,68,240,308,117,60,87,131,194,1242
Justin Jackson,AL,28,MIN,2,0,1,0,0,,0,0,,0,0,,,0,0,,0,0,0,0,0,0,0,0,0
Reggie Jackson,BA,33,DEN,62,16,1407,254,570,0.446,75,212,0.354,179,358,0.5,0.511,52,67,0.776,23,101,124,237,34,9,79,113,635
Trayce Jackson-Davis,AP,23,GSW,48,3,632,138,198,0.697,0,0,,138,198,0.697,0.697,49,85,0.576,81,114,195,44,14,43,31,76,325
LeBron James,AP,39,LAL,56,56,1962,535,1013,0.528,122,301,0.405,413,712,0.58,0.588,223,301,0.741,47,348,395,448,71,33,180,65,1415
Jaime Jaquez Jr.,AL,22,MIA,55,17,1620,270,548,0.493,49,153,0.32,221,395,0.559,0.537,108,133,0.812,70,148,218,142,60,11,90,127,697
DaQuan Jeffries,ES,26,NYK,13,0,34,5,14,0.357,1,7,0.143,4,7,0.571,0.393,0,2,0.0,0,5,5,2,0,0,1,2,11
Trey Jemison,P,24,TOT,11,5,190,24,45,0.533,0,0,,24,45,0.533,0.533,7,9,0.778,18,26,44,8,4,11,11,34,55
Ty Jerome,ES,26,CLE,2,0,15,2,4,0.5,0,1,0.0,2,3,0.667,0.5,0,0,,1,0,1,3,0,0,1,2,4
Isaiah Joe,ES,24,OKC,58,0,1068,164,354,0.463,109,261,0.418,55,93,0.591,0.617,34,40,0.85,22,109,131,65,35,17,35,67,471
Cameron Johnson,AP,27,BRK,49,45,1359,243,537,0.453,120,303,0.396,123,234,0.526,0.564,68,88,0.773,50,166,216,122,41,13,48,92,674
Jalen Johnson,AL,22,ATL,48,45,1630,304,582,0.522,56,162,0.346,248,420,0.59,0.57,88,121,0.727,63,351,414,165,55,43,83,122,752
James Johnson,AP,36,IND,6,0,32,2,6,0.333,0,1,0.0,2,5,0.4,0.333,2,2,1.0,1,3,4,6,4,1,2,7,6
Keldon Johnson,AL,24,SAS,58,26,1717,333,741,0.449,103,301,0.342,230,440,0.523,0.519,148,189,0.783,79,236,315,173,46,18,88,132,917
Keon Johnson,ES,21,BRK,4,0,51,7,19,0.368,4,9,0.444,3,10,0.3,0.474,10,10,1.0,3,2,5,3,3,1,4,4,28
Keyontae Johnson,AL,23,OKC,9,0,66,5,16,0.313,1,3,0.333,4,13,0.308,0.344,0,0,,4,6,10,4,1,0,4,5,11
Nikola Jokić,P,28,DEN,60,60,2050,611,1055,0.579,64,183,0.35,547,872,0.627,0.609,270,330,0.818,172,566,738,549,72,55,179,154,1556
Colby Jones,ES,21,SAC,17,0,121,17,46,0.37,1,13,0.077,16,33,0.485,0.38,2,5,0.4,10,15,25,10,4,1,5,16,37
Damian Jones,P,28,CLE,26,0,161,18,33,0.545,2,7,0.286,16,26,0.615,0.576,10,11,0.909,10,25,35,12,3,11,9,17,48
Derrick Jones Jr.,AL,26,DAL,57,47,1367,187,382,0.49,68,191,0.356,119,191,0.623,0.579,72,100,0.72,62,139,201,55,41,39,51,93,514
Herbert Jones,AL,25,NOP,57,57,1671,233,452,0.515,89,204,0.436,144,248,0.581,0.614,98,115,0.852,62,144,206,140,74,44,67,166,653
Mason Jones,ES,25,SAC,1,0,13,0,3,0.0,0,2,0.0,0,1,0.0,0.0,1,2,0.5,1,3,4,4,0,0,0,0,1
Tre Jones,BA,24,SAS,57,28,1500,215,425,0.506,41,131,0.313,174,294,0.592,0.554,77,88,0.875,39,148,187,333,54,7,82,68,548
Tyus Jones,BA,27,WAS,62,62,1808,312,630,0.495,100,237,0.422,212,393,0.539,0.575,30,38,0.789,20,150,170,448,69,17,61,46,754
DeAndre Jordan,P,35,DEN,29,1,327,48,76,0.632,0,0,,48,76,0.632,0.632,22,49,0.449,48,84,132,20,5,13,19,48,118
Cory Joseph,BA,32,GSW,26,0,296,23,64,0.359,13,42,0.31,10,22,0.455,0.461,4,7,0.571,6,24,30,42,4,3,12,25,63
Nikola Jović,AP,20,MIA,27,19,465,59,134,0.44,32,71,0.451,27,63,0.429,0.56,15,28,0.536,18,92,110,51,12,8,25,49,165
Johnny Juzang,ES,22,UTA,5,0,49,5,17,0.294,2,12,0.167,3,5,0.6,0.353,0,0,,2,5,7,3,0,0,1,2,12
Luke Kennard,ES,27,MEM,32,15,799,115,250,0.46,88,191,0.461,27,59,0.458,0.636,38,43,0.884,9,80,89,97,15,1,37,34,356
Walker Kessler,P,22,UTA,51,17,1189,191,293,0.652,4,19,0.211,187,274,0.682,0.659,46,81,0.568,130,249,379,44,26,138,53,109,432
Braxton Key,AL,26,DEN,17,0,55,6,16,0.375,1,4,0.25,5,12,0.417,0.406,4,6,0.667,3,11,14,8,2,1,1,5,17
Corey Kispert,AL,24,WAS,60,3,1360,263,551,0.477,122,336,0.363,141,215,0.656,0.588,82,107,0.766,19,132,151,103,26,11,70,99,730
Maxi Kleber,P,32,DAL,25,7,550,43,101,0.426,20,61,0.328,23,40,0.575,0.525,19,29,0.655,17,70,87,42,8,16,20,51,125
Kevin Knox,AL,24,DET,31,11,560,86,186,0.462,31,94,0.33,55,92,0.598,0.546,20,22,0.909,18,57,75,23,13,7,22,50,223
John Konchar,AL,27,MEM,48,17,953,73,173,0.422,30,99,0.303,43,74,0.581,0.509,17,20,0.85,58,151,209,87,41,46,34,63,193
Furkan Korkmaz,ES,26,PHI,35,0,300,30,76,0.395,14,40,0.35,16,36,0.444,0.487,14,20,0.7,4,26,30,25,14,3,10,17,88
Luke Kornet,P,28,BOS,44,2,642,91,132,0.689,0,0,,91,132,0.689,0.689,31,35,0.886,78,90,168,37,16,43,17,61,213
Vit Krejci,BA,23,ATL,2,0,6,0,0,,0,0,,0,0,,,0,0,,0,0,0,0,0,0,0,1,0
Jonathan Kuminga,AP,21,GSW,60,34,1538,360,678,0.531,42,138,0.304,318,540,0.589,0.562,176,241,0.73,79,206,285,125,41,30,96,127,938
Kyle Kuzma,AP,28,WAS,60,60,1917,523,1132,0.462,140,407,0.344,383,725,0.528,0.524,149,193,0.772,59,332,391,245,30,42,156,129,1335
Jock Landale,P,28,HOU,36,0,322,31,82,0.378,2,19,0.105,29,63,0.46,0.39,19,24,0.792,47,38,85,22,9,13,12,35,83
Jake LaRavia,AP,22,MEM,18,0,286,40,108,0.37,12,51,0.235,28,57,0.491,0.426,26,34,0.765,22,35,57,17,7,6,15,33,118
Zach LaVine,ES,28,CHI,25,23,872,170,376,0.452,59,169,0.349,111,207,0.536,0.531,88,103,0.854,8,121,129,98,21,8,52,57,487
A.J. Lawson,ES,23,DAL,29,0,233,41,86,0.477,13,40,0.325,28,46,0.609,0.552,12,19,0.632,12,21,33,13,9,3,10,19,107
Saben Lee,BA,24,PHO,19,0,158,18,45,0.4,2,13,0.154,16,32,0.5,0.422,28,37,0.757,8,21,29,25,7,3,7,10,66
Alex Len,P,30,SAC,27,0,237,31,54,0.574,0,3,0.0,31,51,0.608,0.574,7,17,0.412,32,48,80,23,8,15,17,32,69
Kawhi Leonard,AL,32,LAC,56,56,1933,507,970,0.523,123,288,0.427,384,682,0.563,0.586,212,238,0.891,68,278,346,210,98,47,94,84,1349
Caris LeVert,ES,29,CLE,50,1,1394,255,615,0.415,83,252,0.329,172,363,0.474,0.482,105,139,0.755,27,165,192,237,47,23,77,88,698
Kira Lewis Jr.,BA,22,TOT,19,0,153,17,54,0.315,2,21,0.095,15,33,0.455,0.333,10,11,0.909,5,10,15,21,6,1,8,9,46
Maxwell Lewis,AL,21,LAL,22,0,74,3,12,0.25,1,3,0.333,2,9,0.222,0.292,0,0,,1,2,3,3,2,0,7,4,7
E.J. Liddell,AP,23,NOP,8,0,23,1,6,0.167,0,5,0.0,1,1,1.0,0.167,2,2,1.0,0,5,5,1,2,2,2,2,4
Damian Lillard,BA,33,MIL,58,58,2024,427,1009,0.423,173,494,0.35,254,515,0.493,0.509,391,422,0.927,30,220,250,388,61,12,151,103,1418
Nassir Little,AL,23,PHO,34,2,426,49,107,0.458,19,60,0.317,30,47,0.638,0.547,17,20,0.85,14,57,71,19,10,10,13,37,134
Dereck Lively II,P,19,DAL,44,42,1085,174,234,0.744,0,2,0.0,174,232,0.75,0.744,37,70,0.529,117,197,314,51,31,65,44,125,385
Isaiah Livers,AP,25,DET,23,6,469,40,116,0.345,22,77,0.286,18,39,0.462,0.44,12,18,0.667,15,33,48,25,13,5,16,43,114
Chris Livingston,AL,20,MIL,16,0,69,7,16,0.438,1,3,0.333,6,13,0.462,0.469,2,2,1.0,2,13,15,5,2,0,4,11,17
Kenneth Lofton Jr.,AP,21,TOT,17,0,108,15,43,0.349,3,12,0.25,12,31,0.387,0.384,8,15,0.533,2,16,18,14,3,3,8,15,41
Kevon Looney,P,27,GSW,61,36,1033,116,195,0.595,0,1,0.0,116,194,0.598,0.595,46,68,0.676,125,236,361,123,24,22,44,132,278
Brook Lopez,P,35,MIL,60,60,1869,282,593,0.476,108,312,0.346,174,281,0.619,0.567,83,101,0.822,90,232,322,100,37,158,54,148,755
Robin Lopez,P,35,MIL,16,2,65,7,19,0.368,2,8,0.25,5,11,0.455,0.421,2,2,1.0,3,2,5,4,1,3,2,7,18
Kevin Love,AP,35,MIA,47,5,822,135,305,0.443,74,212,0.349,61,93,0.656,0.564,81,104,0.779,50,242,292,105,16,9,38,85,425
Kyle Lowry,BA,37,TOT,43,38,1212,121,281,0.431,72,184,0.391,49,97,0.505,0.559,43,50,0.86,29,120,149,181,45,16,62,108,357
Seth Lundy,AL,23,ATL,9,0,52,4,17,0.235,3,13,0.231,1,4,0.25,0.324,3,4,0.75,1,6,7,0,0,0,1,6,14
Trey Lyles,AP,28,SAC,46,0,922,114,252,0.452,68,176,0.386,46,76,0.605,0.587,39,57,0.684,45,160,205,53,13,14,30,74,335
Théo Maledon,BA,22,TOT,17,1,213,20,70,0.286,5,30,0.167,15,40,0.375,0.321,14,15,0.933,4,20,24,28,7,0,18,21,59
Sandro Mamukelashvili,P,24,SAS,33,0,213,31,71,0.437,8,34,0.235,23,37,0.622,0.493,12,17,0.706,19,37,56,28,6,8,8,22,82
Terance Mann,ES,27,LAC,55,51,1388,173,351,0.493,50,151,0.331,123,200,0.615,0.564,51,64,0.797,69,121,190,98,28,11,34,103,447
Tre Mann,BA,22,TOT,24,11,454,68,148,0.459,25,61,0.41,43,87,0.494,0.544,16,20,0.8,9,72,81,72,21,0,26,25,177
Boban Marjanović,P,35,HOU,9,0,48,10,21,0.476,0,2,0.0,10,19,0.526,0.476,3,6,0.5,6,16,22,4,0,1,2,4,23
Lauri Markkanen,AP,26,UTA,51,51,1677,395,818,0.483,164,409,0.401,231,409,0.565,0.583,222,250,0.888,115,306,421,103,44,24,67,95,1176
Naji Marshall,AL,26,NOP,50,1,946,124,276,0.449,41,112,0.366,83,164,0.506,0.524,62,79,0.785,47,132,179,102,36,10,54,72,351
Caleb Martin,AL,28,MIA,44,19,1187,173,379,0.456,57,145,0.393,116,234,0.496,0.532,56,72,0.778,53,152,205,92,32,17,53,91,459
Cody Martin,AL,28,CHO,28,22,753,82,215,0.381,27,86,0.314,55,129,0.426,0.444,20,33,0.606,19,90,109,104,32,18,44,48,211
KJ Martin,AL,23,TOT,45,2,520,70,124,0.565,6,21,0.286,64,103,0.621,0.589,16,31,0.516,21,63,84,34,18,7,23,71,162
Garrison Mathews,ES,27,ATL,46,4,593,50,116,0.431,45,106,0.425,5,10,0.5,0.625,13,18,0.722,12,49,61,20,11,4,15,73,158
Bennedict Mathurin,AL,21,IND,59,19,1538,296,663,0.446,80,214,0.374,216,449,0.481,0.507,184,224,0.821,60,174,234,119,35,14,97,117,856
Wesley Matthews,ES,37,ATL,22,1,246,15,48,0.313,10,37,0.27,5,11,0.455,0.417,14,20,0.7,4,29,33,13,10,6,6,29,54
Tyrese Maxey,BA,23,PHI,55,55,2056,497,1108,0.449,168,445,0.378,329,663,0.496,0.524,269,309,0.871,31,175,206,345,56,27,94,121,1431
Skylar Mays,,26,TOT,31,5,419,62,156,0.397,16,54,0.296,46,102,0.451,0.449,13,17,0.765,10,32,42,83,17,4,19,25,153
Miles McBride,BA,23,NYK,49,5,722,117,270,0.433,60,152,0.395,57,118,0.483,0.544,22,27,0.815,15,37,52,67,30,5,18,63,316
CJ McCollum,BA,32,NOP,46,46,1443,311,681,0.457,155,367,0.422,156,314,0.497,0.57,81,102,0.794,26,172,198,205,48,34,70,96,858
T.J. McConnell,BA,31,IND,52,4,918,209,378,0.553,7,23,0.304,202,355,0.569,0.562,37,48,0.771,29,110,139,288,54,5,76,56,462
Jaden McDaniels,AL,23,MIN,52,51,1510,221,438,0.505,64,178,0.36,157,260,0.604,0.578,38,51,0.745,39,104,143,70,45,30,66,160,544
Jalen McDaniels,AL,26,TOR,35,0,300,35,107,0.327,11,54,0.204,24,53,0.453,0.379,14,20,0.7,9,33,42,17,11,3,18,30,95
Doug McDermott,AL,32,TOT,52,0,766,102,239,0.427,80,193,0.415,22,46,0.478,0.594,11,19,0.579,9,42,51,61,11,2,25,51,295
JaVale McGee,P,36,SAC,39,0,310,73,116,0.629,0,4,0.0,73,112,0.652,0.629,25,43,0.581,37,75,112,14,9,19,31,44,171
Bryce McGowens,ES,21,CHO,49,13,779,88,192,0.458,30,87,0.345,58,105,0.552,0.536,51,67,0.761,16,74,90,46,19,7,26,69,257
Jordan McLaughlin,BA,27,MIN,37,0,329,36,85,0.424,21,49,0.429,15,36,0.417,0.547,4,8,0.5,10,28,38,63,25,6,13,20,97
De'Anthony Melton,ES,25,PHI,36,33,1002,136,348,0.391,75,207,0.362,61,141,0.433,0.499,66,79,0.835,27,110,137,110,56,16,39,82,413
Nathan Mensah,P,25,CHO,25,0,307,12,28,0.429,0,0,,12,28,0.429,0.429,9,12,0.75,29,36,65,9,6,14,14,64,33
Sam Merrill,ES,27,CLE,44,1,710,116,275,0.422,102,242,0.421,14,33,0.424,0.607,12,13,0.923,17,69,86,67,15,1,12,48,346
Chimezie Metu,P,26,PHO,37,5,447,66,130,0.508,15,51,0.294,51,79,0.646,0.565,38,43,0.884,24,86,110,19,19,9,27,39,185
Vasilije Micić,BA,30,TOT,41,2,619,79,190,0.416,19,78,0.244,60,112,0.536,0.466,30,38,0.789,7,37,44,139,17,3,52,37,207
Khris Middleton,AL,32,MIL,43,43,1129,242,497,0.487,73,193,0.378,169,304,0.556,0.56,79,95,0.832,26,158,184,216,38,13,89,104,636
Brandon Miller,AL,21,CHO,55,49,1762,347,788,0.44,130,342,0.38,217,446,0.487,0.523,97,117,0.829,47,182,229,130,50,29,100,140,921
Jordan Miller,AL,24,LAC,5,0,21,4,6,0.667,1,1,1.0,3,5,0.6,0.75,2,2,1.0,2,2,4,0,0,0,1,2,11
Leonard Miller,AL,20,MIN,7,0,26,7,11,0.636,1,3,0.333,6,8,0.75,0.682,0,0,,1,9,10,3,1,1,1,3,15
Dariq Whitehead,AL,19,BRK,2,0,24,1,5,0.2,0,3,0.0,1,2,0.5,0.2,1,2,0.5,0,4,4,3,0,1,0,0,3
Patty Mills,BA,35,ATL,19,0,202,19,51,0.373,13,34,0.382,6,17,0.353,0.5,0,0,,5,15,20,14,9,1,8,17,51
Shake Milton,ES,27,TOT,42,0,554,75,186,0.403,17,62,0.274,58,124,0.468,0.449,38,47,0.809,14,55,69,56,18,6,31,47,205
Justin Minaya,AL,24,POR,20,0,161,7,28,0.25,4,19,0.211,3,9,0.333,0.321,3,6,0.5,10,11,21,8,5,5,5,11,21
Josh Minott,AL,21,MIN,21,0,62,10,21,0.476,1,6,0.167,9,15,0.6,0.5,12,14,0.857,3,9,12,3,3,3,2,7,33
Davion Mitchell,BA,25,SAC,51,4,686,84,187,0.449,32,94,0.34,52,93,0.559,0.535,20,27,0.741,8,46,54,87,11,3,29,64,220
Donovan Mitchell,ES,27,CLE,47,47,1679,454,961,0.472,159,428,0.371,295,533,0.553,0.555,248,288,0.861,42,212,254,290,85,24,137,106,1315
Evan Mobley,AP,22,CLE,38,38,1183,247,427,0.578,11,35,0.314,236,392,0.602,0.591,88,125,0.704,92,296,388,116,34,59,73,108,593
Isaiah Mobley,AP,24,CLE,3,0,14,2,4,0.5,1,2,0.5,1,2,0.5,0.625,0,0,,0,2,2,4,1,0,1,2,5
Malik Monk,ES,25,SAC,60,0,1566,332,736,0.451,134,357,0.375,198,379,0.522,0.542,135,167,0.808,22,149,171,317,38,36,127,123,933
Moses Moody,ES,21,GSW,47,8,826,142,304,0.467,50,143,0.35,92,161,0.571,0.549,49,63,0.778,48,95,143,37,32,19,32,56,383
Xavier Moon,ES,29,LAC,2,0,12,1,2,0.5,0,1,0.0,1,1,1.0,0.5,0,0,,0,2,2,3,0,0,1,1,2
Taze Moore,ES,25,POR,3,0,10,3,5,0.6,0,2,0.0,3,3,1.0,0.6,0,0,,0,0,0,1,1,0,1,2,6
Wendell Moore Jr.,ES,22,MIN,14,0,44,5,10,0.5,0,4,0.0,5,6,0.833,0.5,0,0,,0,6,6,2,5,1,3,4,10
Ja Morant,BA,24,MEM,9,9,318,80,170,0.471,14,51,0.275,66,119,0.555,0.512,52,64,0.813,6,44,50,73,7,5,27,19,226
Marcus Morris,AP,34,PHI,37,7,637,90,205,0.439,36,90,0.4,54,115,0.47,0.527,31,36,0.861,18,91,109,26,13,11,19,61,247
Markieff Morris,AP,34,DAL,18,1,160,16,49,0.327,10,30,0.333,6,19,0.316,0.429,3,4,0.75,4,26,30,11,5,1,9,11,45
Monte Morris,BA,28,TOT,16,0,235,33,89,0.371,11,36,0.306,22,53,0.415,0.433,6,9,0.667,5,23,28,38,8,3,4,6,83
Trey Murphy III,AL,23,NOP,37,10,1000,169,385,0.439,105,279,0.376,64,106,0.604,0.575,64,85,0.753,24,131,155,67,32,19,16,46,507
Dejounte Murray,ES,27,ATL,59,59,2069,486,1051,0.462,131,371,0.353,355,680,0.522,0.525,165,204,0.809,43,269,312,337,76,19,136,99,1268
Jamal Murray,BA,26,DEN,46,46,1452,364,760,0.479,110,264,0.417,254,496,0.512,0.551,117,137,0.854,31,151,182,298,38,30,97,83,955
Keegan Murray,AL,23,SAC,57,57,1878,324,697,0.465,126,350,0.36,198,347,0.571,0.555,77,93,0.828,72,227,299,95,62,40,50,156,851
Kris Murray,AL,23,POR,41,8,665,70,173,0.405,23,84,0.274,47,89,0.528,0.471,18,29,0.621,37,65,102,38,35,8,26,48,181
Mike Muscala,P,32,TOT,38,6,520,50,139,0.36,28,88,0.318,22,51,0.431,0.46,17,24,0.708,32,75,107,32,8,12,18,44,145
Svi Mykhailiuk,AL,26,BOS,26,0,206,26,74,0.351,19,59,0.322,7,15,0.467,0.48,3,6,0.5,8,18,26,14,8,0,8,12,74
Larry Nance Jr.,P,31,NOP,44,0,808,93,158,0.589,20,47,0.426,73,111,0.658,0.652,28,39,0.718,65,162,227,69,40,17,39,67,234
Pete Nance,AP,23,CLE,2,0,4,0,2,0.0,0,0,,0,2,0.0,0.0,0,0,,0,0,0,0,0,0,0,0,0
Andrew Nembhard,BA,24,IND,49,28,1157,189,383,0.493,41,114,0.36,148,269,0.55,0.547,30,38,0.789,28,66,94,211,48,4,80,95,449
Aaron Nesmith,AL,24,IND,54,29,1451,240,468,0.513,111,248,0.448,129,220,0.586,0.631,72,102,0.706,48,155,203,79,55,34,52,178,663
Georges Niang,AP,30,CLE,62,2,1326,198,457,0.433,103,285,0.361,95,172,0.552,0.546,37,45,0.822,19,199,218,74,17,12,49,142,536
Daishen Nix,BA,21,MIN,10,0,35,8,19,0.421,5,13,0.385,3,6,0.5,0.553,1,4,0.25,0,1,1,2,2,0,1,1,22
Zeke Nnaji,AP,23,DEN,47,0,459,55,128,0.43,5,21,0.238,50,107,0.467,0.449,39,55,0.709,55,48,103,26,12,31,27,67,154
Jaylen Nowell,ES,24,MEM,9,1,156,22,55,0.4,4,23,0.174,18,32,0.563,0.436,3,3,1.0,3,11,14,16,3,0,5,13,51
Markquis Nowell,ES,24,TOR,1,0,4,0,1,0.0,0,0,,0,1,0.0,0.0,2,2,1.0,2,0,2,2,1,0,0,0,2
Frank Ntilikina,BA,25,CHO,5,0,43,1,9,0.111,1,8,0.125,0,1,0.0,0.167,2,2,1.0,1,5,6,4,0,0,1,4,5
Jusuf Nurkić,P,29,PHO,58,58,1580,263,510,0.516,21,87,0.241,242,423,0.572,0.536,135,202,0.668,162,461,623,220,59,61,128,196,682
Jordan Nwora,AL,25,TOT,33,1,364,66,157,0.42,22,70,0.314,44,87,0.506,0.49,28,32,0.875,17,53,70,35,12,4,20,35,182
Royce O'Neale,AL,30,TOT,59,10,1487,160,412,0.388,123,330,0.373,37,82,0.451,0.538,21,31,0.677,46,236,282,172,47,36,59,142,464
Chuma Okeke,AL,25,ORL,37,8,392,38,101,0.376,23,74,0.311,15,27,0.556,0.49,2,5,0.4,18,55,73,18,8,7,12,19,101
Josh Okogie,ES,25,PHO,54,11,926,83,199,0.417,27,91,0.297,56,108,0.519,0.485,74,100,0.74,71,77,148,62,47,22,33,65,267
Onyeka Okongwu,P,23,ATL,53,8,1367,214,351,0.61,22,65,0.338,192,286,0.671,0.641,92,115,0.8,143,226,369,71,23,59,45,158,542
Isaac Okoro,AL,23,CLE,53,30,1406,187,373,0.501,65,163,0.399,122,210,0.581,0.588,75,109,0.688,55,104,159,107,46,28,41,104,514
Kelly Olynyk,P,32,TOT,60,9,1233,178,330,0.539,42,106,0.396,136,224,0.607,0.603,109,129,0.845,78,220,298,252,53,19,94,159,507
Eugene Omoruyi,AL,26,WAS,30,0,227,51,104,0.49,6,26,0.231,45,78,0.577,0.519,24,33,0.727,25,36,61,23,19,1,15,41,132
Cedi Osman,AL,28,SAS,62,1,1093,157,331,0.474,71,189,0.376,86,142,0.606,0.582,34,50,0.68,23,132,155,107,33,9,42,90,419
Kelly Oubre Jr.,AL,28,PHI,49,33,1427,261,579,0.451,68,223,0.305,193,356,0.542,0.509,115,153,0.752,63,158,221,59,57,26,52,146,705
Chris Paul,BA,38,GSW,37,11,995,118,280,0.421,53,142,0.373,65,138,0.471,0.516,38,46,0.826,11,127,138,263,49,3,45,65,327
Cameron Payne,BA,29,TOT,58,5,925,144,326,0.442,71,183,0.388,73,143,0.51,0.551,50,58,0.862,12,69,81,144,27,5,41,91,409
Gary Payton II,ES,31,GSW,27,0,424,68,126,0.54,14,40,0.35,54,86,0.628,0.595,9,14,0.643,33,48,81,26,29,10,16,44,159
Drew Peterson,AP,24,BOS,1,0,3,1,1,1.0,1,1,1.0,0,0,,1.5,0,0,,0,0,0,1,0,0,0,1,3
Filip Petrušev,P,23,TOT,3,0,10,1,2,0.5,0,0,,1,2,0.5,0.5,1,2,0.5,0,1,1,0,0,0,0,1,3
Julian Phillips,AL,20,CHI,36,0,274,28,65,0.431,9,31,0.29,19,34,0.559,0.5,10,16,0.625,10,22,32,13,4,6,9,36,75
Jalen Pickett,ES,24,DEN,20,0,107,12,30,0.4,7,22,0.318,5,8,0.625,0.517,3,4,0.75,1,10,11,14,3,0,7,11,34
Scotty Pippen Jr.,BA,23,MEM,8,4,181,28,59,0.475,13,23,0.565,15,36,0.417,0.585,15,21,0.714,8,19,27,36,8,4,15,21,84
Mason Plumlee,P,33,LAC,28,9,477,65,100,0.65,0,0,,65,100,0.65,0.65,48,72,0.667,42,122,164,33,10,12,21,46,178
Brandin Podziemski,ES,20,GSW,53,20,1418,203,450,0.451,66,180,0.367,137,270,0.507,0.524,38,62,0.613,81,226,307,205,44,10,67,94,510
Jakob Poeltl,P,28,TOR,50,50,1319,248,378,0.656,0,0,,248,378,0.656,0.656,59,107,0.551,146,283,429,127,35,76,77,149,555
Aleksej Pokusevski,AP,22,OKC,10,0,60,4,16,0.25,2,11,0.182,2,5,0.4,0.313,2,4,0.5,2,8,10,5,1,1,3,5,12
Jordan Poole,ES,24,WAS,60,52,1761,359,882,0.407,130,409,0.318,229,473,0.484,0.481,155,179,0.866,22,129,151,224,66,20,135,197,1003
Craig Porter Jr.,BA,23,CLE,38,5,519,95,187,0.508,7,23,0.304,88,164,0.537,0.527,35,49,0.714,18,72,90,98,19,12,35,33,232
Jontay Porter,AP,24,TOR,19,5,244,28,76,0.368,13,41,0.317,15,35,0.429,0.454,11,12,0.917,17,41,58,34,12,12,14,30,80
Michael Porter Jr.,AL,25,DEN,61,61,1945,391,814,0.48,169,427,0.396,222,387,0.574,0.584,64,78,0.821,82,354,436,90,30,44,69,116,1015
Otto Porter Jr.,AL,30,TOR,15,1,174,14,33,0.424,8,23,0.348,6,10,0.6,0.545,3,3,1.0,6,23,29,8,5,5,2,19,39
Bobby Portis,AP,28,MIL,63,1,1511,338,674,0.501,75,194,0.387,263,480,0.548,0.557,83,105,0.79,102,344,446,75,47,24,64,151,834
Kristaps Porziņģis,P,28,BOS,45,45,1335,306,583,0.525,87,230,0.378,219,353,0.62,0.599,217,252,0.861,73,239,312,88,28,83,71,124,916
Micah Potter,AP,25,UTA,2,0,7,0,1,0.0,0,1,0.0,0,0,,0.0,0,0,,0,4,4,0,0,0,0,0,0
Dwight Powell,P,32,DAL,51,8,736,67,95,0.705,1,2,0.5,66,93,0.71,0.711,60,83,0.723,81,101,182,75,23,19,28,100,195
Norman Powell,ES,30,LAC,60,1,1547,291,592,0.492,133,294,0.452,158,298,0.53,0.604,100,122,0.82,10,144,154,63,34,20,52,108,815
Jason Preston,BA,24,UTA,1,0,1,0,0,,0,0,,0,0,,,0,0,,1,0,1,0,0,0,1,0,0
Joshua Primo,ES,21,LAC,2,0,10,1,3,0.333,0,1,0.0,1,2,0.5,0.333,0,0,,1,0,1,0,0,1,4,0,2
Taurean Prince,AP,29,LAL,61,49,1755,203,465,0.437,116,297,0.391,87,168,0.518,0.561,38,53,0.717,14,165,179,101,49,29,56,127,560
Payton Pritchard,BA,26,BOS,61,0,1245,179,405,0.442,103,270,0.381,76,135,0.563,0.569,30,37,0.811,53,141,194,165,27,6,41,78,491
Olivier-Maxence Prosper,AP,21,DAL,33,0,260,26,74,0.351,8,34,0.235,18,40,0.45,0.405,23,34,0.676,18,44,62,19,5,3,5,17,83
Trevelin Queen,ES,26,ORL,13,0,163,14,38,0.368,3,17,0.176,11,21,0.524,0.408,9,12,0.75,3,16,19,18,7,5,7,15,40
Neemias Queta,P,24,BOS,23,0,283,49,80,0.613,0,0,,49,80,0.613,0.613,15,20,0.75,44,58,102,11,10,14,9,45,113
Immanuel Quickley,,24,TOT,57,27,1608,313,722,0.434,144,352,0.409,169,370,0.457,0.533,150,177,0.847,14,185,199,238,38,8,71,95,920
Lester Quinones,ES,23,GSW,27,0,345,46,115,0.4,26,70,0.371,20,45,0.444,0.513,17,25,0.68,20,46,66,29,6,2,16,39,135
Jahmi'us Ramsey,ES,22,TOR,1,0,5,1,3,0.333,0,1,0.0,1,2,0.5,0.333,0,0,,1,1,2,1,0,0,0,0,2
Julius Randle,AP,29,NYK,46,46,1630,395,836,0.472,76,244,0.311,319,592,0.539,0.518,236,302,0.781,99,324,423,229,25,12,159,125,1102
Duop Reath,P,27,POR,47,15,851,165,346,0.477,64,175,0.366,101,171,0.591,0.569,50,71,0.704,72,109,181,50,25,28,39,120,444
Austin Reaves,ES,25,LAL,64,39,2015,353,717,0.492,115,307,0.375,238,410,0.58,0.573,183,211,0.867,43,215,258,355,56,14,137,118,1004
Cam Reddish,AL,24,LAL,39,26,871,86,213,0.404,34,99,0.343,52,114,0.456,0.484,36,46,0.783,22,69,91,47,45,11,31,59,242
Paul Reed,P,24,PHI,62,23,1143,187,342,0.547,14,38,0.368,173,304,0.569,0.567,37,50,0.74,138,210,348,79,43,54,44,151,425
Naz Reid,P,24,MIN,62,0,1426,285,591,0.482,116,283,0.41,169,308,0.549,0.58,75,100,0.75,60,240,300,67,42,49,76,124,761
Jared Rhoden,ES,24,DET,6,0,42,6,11,0.545,1,4,0.25,5,7,0.714,0.591,2,2,1.0,1,4,5,4,0,2,3,4,15
Nick Richards,P,26,CHO,52,39,1358,201,291,0.691,0,1,0.0,201,290,0.693,0.691,111,152,0.73,136,277,413,43,18,66,57,138,513
Josh Richardson,ES,30,MIA,43,6,1103,154,347,0.444,66,190,0.347,88,157,0.561,0.539,51,54,0.944,18,103,121,105,24,14,36,76,425
Duncan Robinson,AL,29,MIA,56,24,1581,259,569,0.455,157,387,0.406,102,182,0.56,0.593,72,81,0.889,12,126,138,170,38,14,76,132,747
Jerome Robinson,ES,26,GSW,15,0,60,6,22,0.273,2,13,0.154,4,9,0.444,0.318,6,10,0.6,1,2,3,5,0,3,1,3,20
Mitchell Robinson,P,25,NYK,21,21,613,58,98,0.592,0,0,,58,98,0.592,0.592,14,38,0.368,112,104,216,15,32,27,21,40,130
Orlando Robinson,P,23,MIA,27,7,273,33,67,0.493,7,14,0.5,26,53,0.491,0.545,18,24,0.75,23,55,78,29,7,7,17,35,91
Jeremiah Robinson-Earl,AP,23,NOP,27,1,261,35,70,0.5,12,29,0.414,23,41,0.561,0.586,12,15,0.8,17,42,59,11,9,4,12,18,94
David Roddy,AP,22,TOT,54,13,1139,158,391,0.404,48,159,0.302,110,232,0.474,0.465,47,68,0.691,51,151,202,76,25,11,55,69,411
Ryan Rollins,BA,21,WAS,10,0,66,13,25,0.52,2,3,0.667,11,22,0.5,0.56,13,17,0.765,2,9,11,11,8,3,7,7,41
Derrick Rose,BA,35,MEM,24,7,399,76,165,0.461,15,41,0.366,61,124,0.492,0.506,24,27,0.889,7,38,45,78,8,2,31,21,191
Terry Rozier,,29,TOT,44,43,1492,323,732,0.441,101,300,0.337,222,432,0.514,0.51,144,166,0.867,28,147,175,277,43,16,86,76,891
Rayan Rupert,ES,19,POR,20,0,174,22,59,0.373,12,26,0.462,10,33,0.303,0.475,7,10,0.7,10,21,31,15,4,0,8,15,63
D'Angelo Russell,BA,27,LAL,59,52,1876,381,819,0.465,162,391,0.414,219,428,0.512,0.564,119,148,0.804,21,151,172,365,51,29,117,123,1043
Matt Ryan,AL,26,NOP,19,1,349,47,104,0.452,40,85,0.471,7,19,0.368,0.644,13,14,0.929,6,33,39,16,6,1,18,29,147
Domantas Sabonis,P,27,SAC,61,61,2180,489,806,0.607,28,68,0.412,461,738,0.625,0.624,203,293,0.693,212,609,821,514,54,33,198,191,1209
Luka Šamanić,AP,24,UTA,31,2,208,31,85,0.365,9,36,0.25,22,49,0.449,0.418,18,22,0.818,10,42,52,7,2,5,14,20,89
Jermaine Samuels,AL,25,HOU,11,0,53,8,11,0.727,0,2,0.0,8,9,0.889,0.727,2,2,1.0,2,9,11,2,1,1,0,4,18
Adama Sanogo,AP,21,CHI,3,0,11,3,3,1.0,0,0,,3,3,1.0,1.0,2,3,0.667,2,4,6,0,0,0,1,0,8
Gui Santos,AP,21,GSW,16,0,142,19,39,0.487,7,18,0.389,12,21,0.571,0.577,14,15,0.933,15,28,43,10,3,2,7,16,59
Dario Šarić,P,29,GSW,59,9,1063,176,378,0.466,73,193,0.378,103,185,0.557,0.562,76,89,0.854,71,205,276,141,30,9,73,109,501
Olivier Sarr,P,24,OKC,14,0,95,11,19,0.579,2,6,0.333,9,13,0.692,0.632,10,15,0.667,10,25,35,2,0,7,3,18,34
Marcus Sasser,BA,23,DET,52,0,852,146,321,0.455,59,147,0.401,87,174,0.5,0.547,35,41,0.854,7,74,81,158,31,8,52,71,386
Admiral Schofield,AP,26,ORL,15,0,53,6,16,0.375,3,10,0.3,3,6,0.5,0.469,0,2,0.0,2,7,9,5,0,0,4,7,15
Dennis Schröder,BA,30,TOT,62,40,1871,301,686,0.439,101,270,0.374,200,416,0.481,0.512,139,170,0.818,26,145,171,372,50,11,108,129,842
Dereon Seabron,ES,23,NOP,6,0,55,4,13,0.308,1,2,0.5,3,11,0.273,0.346,5,6,0.833,1,6,7,5,2,1,0,4,14
Alperen Sengun,P,21,HOU,61,61,1985,513,953,0.538,33,111,0.297,480,842,0.57,0.556,239,342,0.699,178,396,574,304,73,45,161,205,1298
Brice Sensabaugh,AL,20,UTA,13,1,139,20,47,0.426,10,26,0.385,10,21,0.476,0.532,6,6,1.0,4,19,23,7,1,0,11,14,56
Collin Sexton,ES,25,UTA,63,40,1590,386,795,0.486,106,262,0.405,280,533,0.525,0.552,268,311,0.862,52,108,160,296,50,13,123,123,1146
Landry Shamet,ES,26,WAS,45,5,719,118,274,0.431,53,157,0.338,65,117,0.556,0.527,38,46,0.826,16,46,62,54,25,10,30,75,327
Day'Ron Sharpe,P,22,BRK,46,1,718,134,230,0.583,4,12,0.333,130,218,0.596,0.591,65,106,0.613,122,185,307,66,21,35,49,102,337
Shaedon Sharpe,ES,20,POR,32,25,1059,176,434,0.406,60,180,0.333,116,254,0.457,0.475,98,119,0.824,42,118,160,94,28,12,72,88,510
Ben Sheppard,ES,22,IND,38,0,449,54,129,0.419,32,89,0.36,22,40,0.55,0.543,14,17,0.824,8,46,54,29,21,2,7,55,154
Pascal Siakam,AP,29,TOT,61,61,2073,512,959,0.534,72,212,0.34,440,747,0.589,0.571,219,297,0.737,97,306,403,287,49,18,115,146,1315
Ben Simmons,BA,27,BRK,15,12,359,43,74,0.581,0,0,,43,74,0.581,0.581,6,15,0.4,31,88,119,86,12,9,27,36,92
Anfernee Simons,ES,24,POR,38,38,1304,303,705,0.43,128,334,0.383,175,371,0.472,0.521,134,146,0.918,18,120,138,210,17,4,104,85,868
Jericho Sims,P,25,NYK,35,10,460,35,47,0.745,0,0,,35,47,0.745,0.745,13,20,0.65,47,69,116,21,5,15,12,33,83
Dmytro Skapintsev,P,25,NYK,2,0,2,0,1,0.0,0,0,,0,1,0.0,0.0,0,0,,0,0,0,0,0,0,0,0,0
Jalen Slawson,AL,24,SAC,5,0,19,2,3,0.667,0,1,0.0,2,2,1.0,0.667,0,0,,0,4,4,2,0,1,2,3,4
Javonte Smart,BA,24,PHI,1,0,1,0,0,,0,0,,0,0,,,0,0,,0,0,0,0,0,0,0,0,0
Marcus Smart,BA,29,MEM,20,20,605,102,237,0.43,42,134,0.313,60,103,0.583,0.519,43,56,0.768,6,47,53,86,41,5,62,53,289
Dennis Smith Jr.,BA,26,BRK,46,1,908,126,294,0.429,24,88,0.273,102,206,0.495,0.469,36,50,0.72,45,102,147,180,54,12,57,102,312
Dru Smith,ES,26,MIA,9,0,131,15,33,0.455,7,17,0.412,8,16,0.5,0.561,2,2,1.0,6,8,14,14,9,3,5,12,39
Ish Smith,BA,35,CHO,43,5,741,66,158,0.418,4,8,0.5,62,150,0.413,0.43,3,4,0.75,11,65,76,145,17,4,47,49,139
Jabari Smith Jr.,AP,20,HOU,57,57,1822,277,616,0.45,97,272,0.357,180,344,0.523,0.528,109,135,0.807,115,371,486,83,39,43,67,154,760
Jalen Smith,P,23,IND,44,13,779,178,291,0.612,47,106,0.443,131,185,0.708,0.692,50,72,0.694,73,172,245,45,11,27,37,94,453
Nick Smith Jr.,ES,19,CHO,37,0,573,88,217,0.406,51,113,0.451,37,104,0.356,0.523,11,13,0.846,16,38,54,45,7,7,32,45,238
Terquavion Smith,BA,21,PHI,12,0,69,16,40,0.4,12,31,0.387,4,9,0.444,0.55,2,3,0.667,0,2,2,10,7,0,4,4,46
Jeremy Sochan,AP,20,SAS,62,61,1832,279,631,0.442,58,176,0.33,221,455,0.486,0.488,90,116,0.776,114,269,383,213,47,27,115,142,706
Pat Spencer,BA,27,GSW,1,0,2,0,0,,0,0,,0,0,,,0,0,,0,0,0,0,0,0,0,0,0
Jaden Springer,,21,TOT,37,1,396,48,126,0.381,8,39,0.205,40,87,0.46,0.413,28,34,0.824,28,34,62,36,25,11,27,51,132
Lamar Stevens,AP,26,TOT,29,2,324,69,136,0.507,8,19,0.421,61,117,0.521,0.537,20,29,0.69,24,58,82,16,11,14,20,32,166
Isaiah Stewart,AP,22,DET,39,38,1200,161,339,0.475,57,151,0.377,104,188,0.553,0.559,57,77,0.74,68,198,266,68,14,32,58,92,436
Julian Strawther,AL,21,DEN,39,0,495,75,200,0.375,38,125,0.304,37,75,0.493,0.47,18,25,0.72,4,48,52,41,17,7,17,48,206
Max Strus,AL,27,CLE,60,60,1932,263,638,0.412,144,423,0.34,119,215,0.553,0.525,62,79,0.785,53,231,284,230,53,28,91,153,732
Jalen Suggs,ES,22,ORL,58,58,1543,255,554,0.46,119,303,0.393,136,251,0.542,0.568,81,107,0.757,40,149,189,149,81,34,111,165,710
Cole Swider,AL,24,MIA,11,0,55,9,25,0.36,5,19,0.263,4,6,0.667,0.46,2,2,1.0,1,3,4,4,1,1,6,2,25
Jae'Sean Tate,AL,28,HOU,54,9,910,93,198,0.47,21,69,0.304,72,129,0.558,0.523,22,32,0.688,53,122,175,57,38,10,28,122,229
Jayson Tatum,AP,25,BOS,58,58,2073,532,1117,0.476,181,486,0.372,351,631,0.556,0.557,324,391,0.829,49,444,493,278,58,34,144,118,1569
Terry Taylor,AP,24,CHI,23,0,161,17,34,0.5,2,9,0.222,15,25,0.6,0.529,2,3,0.667,15,18,33,7,4,2,7,16,38
Garrett Temple,ES,37,TOR,16,0,69,8,21,0.381,2,9,0.222,6,12,0.5,0.429,5,6,0.833,5,6,11,6,3,0,5,6,23
Dalen Terry,ES,21,CHI,40,1,404,33,84,0.393,11,46,0.239,22,38,0.579,0.458,18,26,0.692,15,52,67,50,15,8,19,52,95
Daniel Theis,P,31,TOT,46,3,790,121,226,0.535,19,51,0.373,102,175,0.583,0.577,31,43,0.721,66,116,182,46,18,38,31,104,292
Cam Thomas,ES,22,BRK,48,33,1431,362,828,0.437,96,267,0.36,266,561,0.474,0.495,183,218,0.839,18,120,138,128,36,12,85,99,1003
Amen Thompson,AL,21,HOU,43,6,839,131,265,0.494,7,49,0.143,124,216,0.574,0.508,58,91,0.637,78,162,240,99,52,26,61,98,327
Ausar Thompson,AL,21,DET,61,36,1528,225,461,0.488,19,104,0.183,206,357,0.577,0.509,69,115,0.6,123,267,390,117,66,58,81,170,538
Klay Thompson,AL,33,GSW,58,51,1726,346,821,0.421,189,500,0.378,157,321,0.489,0.537,95,103,0.922,27,175,202,128,33,27,87,103,976
Tristan Thompson,P,32,CLE,36,0,446,61,94,0.649,0,1,0.0,61,93,0.656,0.649,13,42,0.31,59,81,140,40,8,11,23,50,135
JT Thor,AP,21,CHO,47,1,595,52,143,0.364,19,62,0.306,33,81,0.407,0.43,7,13,0.538,39,74,113,18,8,20,12,45,130
Matisse Thybulle,AL,26,POR,58,19,1349,112,285,0.393,72,211,0.341,40,74,0.541,0.519,22,27,0.815,24,94,118,76,104,42,35,85,318
Xavier Tillman Sr.,,25,TOT,37,13,736,93,221,0.421,13,55,0.236,80,166,0.482,0.45,20,45,0.444,56,106,162,59,43,37,29,63,219
Jacob Toppin,AL,23,NYK,8,0,37,5,9,0.556,1,4,0.25,4,5,0.8,0.611,2,2,1.0,3,4,7,3,0,1,1,3,13
Obi Toppin,AP,25,IND,63,28,1385,257,456,0.564,80,199,0.402,177,257,0.689,0.651,61,81,0.753,66,175,241,96,33,31,54,113,655
Juan Toscano-Anderson,AL,30,SAC,11,0,53,3,12,0.25,1,4,0.25,2,8,0.25,0.292,0,0,,4,10,14,4,1,1,2,11,7
Karl-Anthony Towns,AP,28,MIN,60,60,1969,472,932,0.506,134,317,0.423,338,615,0.55,0.578,250,286,0.874,91,413,504,179,43,40,169,198,1328
Gary Trent Jr.,ES,25,TOR,57,27,1536,249,595,0.418,137,336,0.408,112,259,0.432,0.534,40,57,0.702,16,120,136,85,56,9,37,71,675
Oscar Tshiebwe,AP,24,IND,8,0,42,10,20,0.5,0,0,,10,20,0.5,0.5,6,8,0.75,8,8,16,2,2,1,0,3,26
P.J. Tucker,AP,38,TOT,18,3,269,6,20,0.3,5,16,0.313,1,4,0.25,0.425,3,3,1.0,17,31,48,8,9,3,5,38,20
Myles Turner,P,27,IND,59,59,1613,368,704,0.523,80,241,0.332,288,463,0.622,0.58,202,256,0.789,96,322,418,75,33,101,87,185,1018
Hunter Tyson,AP,23,DEN,10,0,30,2,10,0.2,1,8,0.125,1,2,0.5,0.25,0,0,,1,7,8,1,0,0,2,6,5
Stanley Umude,ES,24,DET,17,0,190,25,52,0.481,17,31,0.548,8,21,0.381,0.644,22,24,0.917,4,27,31,9,4,5,11,28,89
Jonas Valančiūnas,P,31,NOP,62,62,1559,332,584,0.568,35,96,0.365,297,488,0.609,0.598,134,168,0.798,161,428,589,137,25,62,86,174,833
Jarred Vanderbilt,AP,24,LAL,29,6,581,59,114,0.518,8,27,0.296,51,87,0.586,0.553,24,36,0.667,41,97,138,36,36,5,28,43,150
Fred VanVleet,BA,29,HOU,55,55,2025,304,743,0.409,165,435,0.379,139,308,0.451,0.52,138,162,0.852,23,184,207,438,65,47,92,127,911
Devin Vassell,ES,23,SAS,57,51,1837,410,875,0.469,141,379,0.372,269,496,0.542,0.549,139,176,0.79,27,196,223,221,59,21,88,58,1100
Sasha Vezenkov,AP,28,SAC,35,0,440,74,165,0.448,38,100,0.38,36,65,0.554,0.564,10,13,0.769,30,56,86,15,16,7,11,35,196
Gabe Vincent,BA,27,LAL,5,0,127,12,32,0.375,2,17,0.118,10,15,0.667,0.406,1,2,0.5,2,3,5,15,6,0,2,12,27
Nikola Vučević,P,33,CHI,57,55,1965,437,922,0.474,66,239,0.276,371,683,0.543,0.51,76,91,0.835,163,449,612,190,40,47,89,151,1016
Dean Wade,AP,27,CLE,53,31,1075,96,230,0.417,79,200,0.395,17,30,0.567,0.589,20,26,0.769,36,178,214,41,40,24,20,91,291
Franz Wagner,AL,22,ORL,55,55,1821,417,865,0.482,83,273,0.304,334,592,0.564,0.53,205,242,0.847,56,249,305,219,56,24,117,128,1122
Moritz Wagner,P,26,ORL,61,1,1126,262,439,0.597,29,89,0.326,233,350,0.666,0.63,138,171,0.807,96,185,281,73,31,18,74,130,691
Ish Wainright,AL,29,POR,7,0,46,6,18,0.333,6,16,0.375,0,2,0.0,0.5,2,2,1.0,0,9,9,0,2,1,1,4,20
Jabari Walker,AL,21,POR,57,15,1260,179,382,0.469,28,106,0.264,151,276,0.547,0.505,96,125,0.768,116,252,368,50,35,21,53,133,482
Jarace Walker,AP,20,IND,21,0,208,30,76,0.395,14,37,0.378,16,39,0.41,0.487,6,7,0.857,8,30,38,27,12,9,12,19,80
Lonnie Walker IV,ES,25,BRK,42,0,759,170,379,0.449,89,207,0.43,81,172,0.471,0.566,39,51,0.765,9,81,90,59,29,12,40,59,468
Cason Wallace,ES,20,OKC,62,9,1266,159,317,0.502,71,173,0.41,88,144,0.611,0.614,23,29,0.793,40,101,141,83,49,26,28,97,412
Jordan Walsh,AL,19,BOS,4,0,33,1,5,0.2,0,3,0.0,1,2,0.5,0.2,0,0,,2,9,11,2,2,1,2,5,2
P.J. Washington,AP,25,TOT,54,26,1610,274,614,0.446,97,302,0.321,177,312,0.567,0.525,79,111,0.712,64,222,286,112,47,40,80,133,724
TyTy Washington Jr.,BA,22,MIL,5,0,21,1,7,0.143,1,3,0.333,0,4,0.0,0.214,0,0,,0,1,1,1,2,0,2,0,3
Yuta Watanabe,AL,29,TOT,34,0,464,41,116,0.353,25,85,0.294,16,31,0.516,0.461,10,17,0.588,11,43,54,15,12,7,19,39,117
Lindy Waters III,ES,26,OKC,26,0,176,24,55,0.436,22,51,0.431,2,4,0.5,0.636,0,0,,2,24,26,15,2,4,5,17,70
Trendon Watford,AP,23,BRK,44,0,511,99,187,0.529,14,40,0.35,85,147,0.578,0.567,42,47,0.894,36,80,116,55,15,12,31,70,254
Peyton Watson,AL,21,DEN,60,4,1094,154,331,0.465,40,124,0.323,114,207,0.551,0.526,55,81,0.679,40,132,172,62,33,59,45,103,403
Victor Wembanyama,P,20,SAS,56,56,1610,423,901,0.469,94,281,0.335,329,620,0.531,0.522,220,270,0.815,121,453,574,192,72,193,194,123,1160
Blake Wesley,ES,20,SAS,41,1,536,63,127,0.496,4,31,0.129,59,96,0.615,0.512,30,48,0.625,11,37,48,106,20,4,32,60,160
Russell Westbrook,BA,35,LAC,58,10,1313,257,569,0.452,37,138,0.268,220,431,0.51,0.484,90,133,0.677,80,214,294,256,65,21,118,103,641
Coby White,BA,23,CHI,62,62,2283,433,948,0.457,179,456,0.393,254,492,0.516,0.551,176,211,0.834,34,262,296,329,43,15,135,144,1221
Derrick White,ES,29,BOS,57,57,1828,303,646,0.469,151,373,0.405,152,273,0.557,0.586,114,127,0.898,37,190,227,281,59,71,91,115,871
Cam Whitmore,AL,19,HOU,36,1,634,162,346,0.468,58,159,0.365,104,187,0.556,0.552,55,82,0.671,29,106,135,18,22,10,35,47,437
Aaron Wiggins,ES,25,OKC,59,0,858,142,249,0.57,46,92,0.5,96,157,0.611,0.663,36,46,0.783,44,94,138,51,34,10,36,69,366
Andrew Wiggins,AL,28,GSW,52,41,1402,250,552,0.453,60,170,0.353,190,382,0.497,0.507,93,128,0.727,80,140,220,90,30,27,64,113,653
Lindell Wigginton,BA,25,MIL,3,0,8,2,5,0.4,0,2,0.0,2,3,0.667,0.4,2,2,1.0,0,0,0,0,0,0,1,1,6
Alondes Williams,ES,24,MIA,2,0,9,0,3,0.0,0,2,0.0,0,1,0.0,0.0,0,0,,0,1,1,0,0,0,1,0,0
Brandon Williams,BA,24,DAL,12,0,59,8,22,0.364,2,6,0.333,6,16,0.375,0.409,6,11,0.545,3,4,7,12,1,1,3,2,24
Grant Williams,AP,25,TOT,58,34,1568,182,419,0.434,97,260,0.373,85,159,0.535,0.55,72,93,0.774,63,166,229,106,29,32,75,170,533
Jalen Williams,AP,22,OKC,56,56,1790,423,784,0.54,86,190,0.453,337,594,0.567,0.594,150,184,0.815,29,197,226,253,60,29,95,148,1082
Jaylin Williams,P,21,OKC,50,0,628,65,165,0.394,38,105,0.362,27,60,0.45,0.509,23,28,0.821,27,134,161,67,20,18,20,70,191
Jeenathan Williams,ES,24,HOU,11,0,76,14,30,0.467,1,3,0.333,13,27,0.481,0.483,4,7,0.571,8,2,10,6,2,0,2,9,33
Kenrich Williams,AP,29,OKC,51,1,726,84,187,0.449,39,101,0.386,45,86,0.523,0.553,3,10,0.3,37,104,141,62,25,6,20,69,210
Mark Williams,P,22,CHO,19,19,508,98,151,0.649,0,0,,98,151,0.649,0.649,46,64,0.719,76,108,184,22,16,20,17,50,242
Patrick Williams,AP,22,CHI,43,30,1174,159,359,0.443,59,148,0.399,100,211,0.474,0.525,52,66,0.788,46,120,166,66,40,33,57,87,429
Robert Williams,P,26,POR,6,0,119,17,26,0.654,0,0,,17,26,0.654,0.654,7,9,0.778,11,27,38,5,7,7,7,17,41
Vince Williams Jr.,ES,23,MEM,51,32,1400,165,371,0.445,76,204,0.373,89,167,0.533,0.547,101,126,0.802,59,226,285,169,47,33,86,131,507
Ziaire Williams,AL,22,MEM,51,15,1038,150,378,0.397,58,189,0.307,92,189,0.487,0.474,62,75,0.827,35,145,180,75,36,9,66,85,420
Zion Williamson,AP,23,NOP,51,51,1556,444,771,0.576,5,13,0.385,439,758,0.579,0.579,230,335,0.687,89,192,281,264,45,28,131,116,1123
Jalen Wilson,AP,23,BRK,24,1,345,40,90,0.444,15,37,0.405,25,53,0.472,0.528,21,23,0.913,28,37,65,28,6,1,6,27,116
Dylan Windler,AL,27,TOT,11,0,35,5,11,0.455,5,10,0.5,0,1,0.0,0.682,0,0,,0,4,4,7,0,0,0,3,15
James Wiseman,P,22,DET,42,0,605,107,162,0.66,0,2,0.0,107,160,0.669,0.66,31,51,0.608,64,112,176,28,7,24,35,89,245
Christian Wood,AP,28,LAL,50,1,872,123,264,0.466,35,114,0.307,88,150,0.587,0.532,66,94,0.702,39,215,254,49,16,33,50,72,347
Delon Wright,BA,31,TOT,36,1,512,52,131,0.397,16,42,0.381,36,89,0.404,0.458,29,35,0.829,14,49,63,91,38,9,11,23,149
Thaddeus Young,AP,35,TOT,25,6,379,57,93,0.613,1,6,0.167,56,87,0.644,0.618,5,14,0.357,36,49,85,50,19,3,12,42,120
Trae Young,BA,25,ATL,51,51,1862,418,982,0.426,169,456,0.371,249,526,0.473,0.512,339,396,0.856,22,118,140,553,70,11,220,106,1344
Omer Yurtseven,P,25,UTA,34,6,313,49,94,0.521,4,17,0.235,45,77,0.584,0.543,8,15,0.533,45,81,126,16,5,14,25,39,110
Cody Zeller,P,31,NOP,39,0,301,25,60,0.417,1,3,0.333,24,57,0.421,0.425,22,36,0.611,46,61,107,36,8,5,15,42,73
Ivica Zubac,P,26,LAC,49,49,1286,239,369,0.648,0,0,,239,369,0.648,0.648,83,124,0.669,146,307,453,66,11,60,58,134,561
