Player,Salario,Pos,Age,Tm,G,GS,MP,FG,FGA,FG%,3P,3PA,3P%,2P,2PA,2P%,eFG%,FT,FTA,FT%,ORB,DRB,TRB,AST,STL,BLK,TOV,PF,PTS
DeMar DeRozan,27739975,AP,31,SAS,61,61,2056,455,920,0.495,19,74,0.257,436,846,0.515,0.505,387,440,0.88,40,219,259,422,56,15,119,128,1316
LaMarcus Aldridge,16750000,P,35,TOT,26,23,674,140,296,0.473,31,80,0.388,109,216,0.505,0.525,41,47,0.872,19,99,118,49,11,29,27,47,352
LaMarcus Aldridge,554988,P,35,TOT,26,23,674,140,296,0.473,31,80,0.388,109,216,0.505,0.525,41,47,0.872,19,99,118,49,11,29,27,47,352
Rudy Gay,14500000,AP,34,SAS,63,1,1358,264,628,0.42,106,278,0.381,158,350,0.451,0.505,82,102,0.804,42,261,303,88,45,40,65,115,716
Dejounte Murray,14286000,BA,24,SAS,67,67,2139,441,974,0.453,63,199,0.317,378,775,0.488,0.485,106,134,0.791,58,415,473,363,101,7,117,135,1051
Patty Mills,13535714,BA,32,SAS,68,1,1685,252,611,0.412,161,429,0.375,91,182,0.5,0.544,71,78,0.91,18,98,116,162,42,3,66,81,736
Trey Lyles,5500000,AP,25,SAS,23,9,358,43,90,0.478,14,40,0.35,29,50,0.58,0.556,15,23,0.652,9,77,86,14,6,1,6,13,115
Devin Vassell,4033440,AL,20,SAS,62,7,1056,123,303,0.406,52,150,0.347,71,153,0.464,0.492,43,51,0.843,24,150,174,56,43,18,22,88,341
Derrick White,3516284,ES,26,SAS,36,32,1064,186,453,0.411,84,243,0.346,102,210,0.486,0.503,97,114,0.851,13,94,107,127,26,36,45,91,553
Luka Šamanić,2824320,AP,21,SAS,33,4,308,47,105,0.448,12,43,0.279,35,62,0.565,0.505,16,29,0.552,16,52,68,15,8,8,20,43,122
Keldon Johnson,2048040,AL,21,SAS,69,67,1968,338,705,0.479,60,181,0.331,278,524,0.531,0.522,145,196,0.74,93,319,412,121,40,24,78,142,881
Marquese Chriss,1824003,AP,23,GSW,2,0,27,5,14,0.357,1,5,0.2,4,9,0.444,0.393,2,4,0.5,3,10,13,2,0,2,2,3,13
Drew Eubanks,1620564,P,23,SAS,54,3,755,116,205,0.566,2,2,1.0,114,203,0.562,0.571,77,106,0.726,74,167,241,42,18,49,45,88,311
DaQuan Jeffries,1445697,ES,23,TOT,31,5,493,50,120,0.417,20,67,0.299,30,53,0.566,0.5,7,8,0.875,19,52,71,22,15,10,14,48,127
Gorgui Dieng,1000000,P,31,TOT,38,1,552,85,163,0.521,30,70,0.429,55,93,0.591,0.613,58,67,0.866,40,100,140,48,26,16,32,56,258
Gorgui Dieng,16587688,P,31,TOT,38,1,552,85,163,0.521,30,70,0.429,55,93,0.591,0.613,58,67,0.866,40,100,140,48,26,16,32,56,258
Tre Jones,898310,BA,21,SAS,37,1,269,37,78,0.474,3,5,0.6,34,73,0.466,0.494,17,19,0.895,8,13,21,39,8,0,13,13,94
John Wall,40866760,BA,30,HOU,40,40,1288,293,726,0.404,79,249,0.317,214,477,0.449,0.458,158,211,0.749,17,112,129,275,42,31,141,46,823
Eric Gordon,16869276,ES,32,HOU,27,13,789,159,367,0.433,69,210,0.329,90,157,0.573,0.527,94,114,0.825,8,50,58,71,14,13,51,44,481
Christian Wood,13015874,P,25,HOU,41,41,1326,329,640,0.514,77,206,0.374,252,434,0.581,0.574,125,198,0.631,76,319,395,71,34,48,80,88,860
Kelly Olynyk,12819649,AP,29,TOT,70,62,1997,337,697,0.484,126,368,0.342,211,329,0.641,0.574,145,175,0.829,87,402,489,203,79,42,126,207,945
Dante Exum,9600000,ES,25,CLE,6,3,116,10,26,0.385,2,11,0.182,8,15,0.533,0.423,1,2,0.5,2,15,17,13,4,2,7,9,23
D.J. Augustin,6666667,BA,33,TOT,57,12,1129,135,343,0.394,83,217,0.382,52,126,0.413,0.515,85,94,0.904,20,74,94,188,28,1,65,56,438
Avery Bradley,5635000,ES,30,TOT,27,6,602,64,171,0.374,33,101,0.327,31,70,0.443,0.471,12,15,0.8,8,49,57,46,21,3,28,55,173
D.J. Wilson,4548280,AP,24,TOT,35,1,433,68,168,0.405,30,87,0.345,38,81,0.469,0.494,17,25,0.68,20,92,112,23,11,16,22,44,183
Ben McLemore,2283034,ES,27,TOT,53,5,905,135,365,0.37,97,280,0.346,38,85,0.447,0.503,39,53,0.736,15,85,100,39,23,9,42,88,406
Ben McLemore,455090,ES,27,TOT,53,5,905,135,365,0.37,97,280,0.346,38,85,0.447,0.503,39,53,0.736,15,85,100,39,23,9,42,88,406
David Nwaba,1824003,AL,28,HOU,30,9,679,106,218,0.486,17,63,0.27,89,155,0.574,0.525,47,68,0.691,40,78,118,31,30,21,17,60,276
Sterling Brown,1620564,ES,25,HOU,51,14,1229,150,335,0.448,91,215,0.423,59,120,0.492,0.584,25,31,0.806,38,186,224,72,38,12,41,97,416
DeMarcus Cousins,1620564,P,30,TOT,41,11,713,130,305,0.426,47,135,0.348,83,170,0.488,0.503,59,81,0.728,53,210,263,76,34,24,64,107,366
DeMarcus Cousins,455091,P,30,TOT,41,11,713,130,305,0.426,47,135,0.348,83,170,0.488,0.503,59,81,0.728,53,210,263,76,34,24,64,107,366
Jae'Sean Tate,1445967,AL,25,HOU,70,58,2043,316,625,0.506,60,195,0.308,256,430,0.595,0.554,102,147,0.694,132,242,374,178,85,36,98,222,794
Bruno Caboclo,361256,AP,25,HOU,6,0,36,8,17,0.471,0,5,0.0,8,12,0.667,0.471,1,2,0.5,3,11,14,1,0,2,4,6,17
Khyri Thomas,360998,ES,24,HOU,5,2,153,32,66,0.485,9,27,0.333,23,39,0.59,0.553,9,9,1.0,7,11,18,25,9,6,6,8,82
Khyri Thomas,744684,ES,24,HOU,5,2,153,32,66,0.485,9,27,0.333,23,39,0.59,0.553,9,9,1.0,7,11,18,25,9,6,6,8,82
Mason Jones,61528,ES,22,TOT,32,1,334,52,123,0.423,24,66,0.364,28,57,0.491,0.52,40,64,0.625,7,48,55,42,7,1,29,24,168
Cameron Oliver,43070,AL,24,HOU,4,0,87,19,33,0.576,4,13,0.308,15,20,0.75,0.636,1,4,0.25,5,16,21,5,2,4,3,11,43
Damian Lillard,31626953,BA,30,POR,67,67,2398,602,1334,0.451,275,704,0.391,327,630,0.519,0.554,449,484,0.928,32,251,283,505,62,17,203,102,1928
CJ McCollum,29354152,ES,29,POR,47,47,1600,405,884,0.458,169,420,0.402,236,464,0.509,0.554,108,133,0.812,30,155,185,223,44,21,65,87,1087
Jusuf Nurkić,12888889,P,26,POR,37,37,880,171,333,0.514,12,30,0.4,159,303,0.525,0.532,70,113,0.619,86,246,332,125,38,39,73,103,424
Robert Covington,12138345,AP,30,POR,70,70,2243,204,509,0.401,135,356,0.379,69,153,0.451,0.533,50,62,0.806,61,405,466,117,101,84,64,195,593
Norman Powell,10865952,AL,27,TOT,69,58,2205,438,918,0.477,171,416,0.411,267,502,0.532,0.57,236,271,0.871,42,173,215,129,82,18,119,160,1283
Enes Freedom,5005350,P,28,POR,72,35,1758,339,561,0.604,1,4,0.25,338,557,0.607,0.605,127,164,0.774,284,511,795,84,33,48,78,168,806
Anfernee Simons,2252040,ES,21,POR,64,0,1104,168,401,0.419,120,282,0.426,48,119,0.403,0.569,46,57,0.807,14,126,140,89,18,8,43,96,502
Nassir Little,2210640,AP,20,POR,48,2,640,78,167,0.467,28,80,0.35,50,87,0.575,0.551,36,45,0.8,32,96,128,23,5,13,18,51,220
Anderson Varejão,1913345,P,38,CLE,5,0,36,4,16,0.25,0,1,0.0,4,15,0.267,0.25,5,9,0.556,7,13,20,3,0,2,1,3,13
Anderson Varejão,144297,P,38,CLE,5,0,36,4,16,0.25,0,1,0.0,4,15,0.267,0.25,5,9,0.556,7,13,20,3,0,2,1,3,13
Carmelo Anthony,1620564,AP,36,POR,69,3,1690,327,777,0.421,133,325,0.409,194,452,0.429,0.506,137,154,0.89,32,182,214,104,46,38,61,144,924
Harry Giles,1620564,P,22,POR,38,0,348,42,97,0.433,8,23,0.348,34,74,0.459,0.474,16,27,0.593,31,102,133,29,8,13,20,54,108
CJ Elleby,898310,AL,20,POR,30,0,192,25,66,0.379,7,34,0.206,18,32,0.563,0.432,11,15,0.733,11,21,32,10,6,3,5,27,68
Rondae Hollis-Jefferson,432891,AP,26,POR,11,1,107,9,18,0.5,0,1,0.0,9,17,0.529,0.5,9,16,0.563,11,15,26,13,2,4,2,15,27
Mike Conley,34504132,BA,33,UTA,51,51,1498,284,640,0.444,138,335,0.412,146,305,0.479,0.552,121,142,0.852,36,141,177,305,70,9,99,98,827
Rudy Gobert,27525281,P,28,UTA,71,71,2187,391,579,0.675,0,4,0.0,391,575,0.68,0.675,233,374,0.623,240,720,960,89,40,190,118,163,1015
Bojan Bogdanović,17661000,AL,31,UTA,72,72,2216,406,925,0.439,180,461,0.39,226,464,0.487,0.536,233,265,0.879,40,241,281,136,45,4,128,115,1225
Jordan Clarkson,11500000,ES,28,UTA,68,1,1818,457,1075,0.425,208,599,0.347,249,476,0.523,0.522,129,144,0.896,47,227,274,168,61,10,115,110,1251
Joe Ingles,10863637,AL,33,UTA,67,30,1867,275,562,0.489,183,406,0.451,92,156,0.59,0.652,76,90,0.844,27,217,244,318,45,12,117,120,809
Derrick Favors,9258000,P,29,UTA,68,0,1039,155,243,0.638,0,2,0.0,155,241,0.643,0.638,59,80,0.738,138,238,376,44,32,68,36,143,369
Royce O'Neale,8500000,AL,27,UTA,71,71,2241,175,394,0.444,107,278,0.385,68,116,0.586,0.58,39,46,0.848,88,397,485,181,57,32,83,182,496
Donovan Mitchell,5195501,BA,24,UTA,53,53,1771,478,1091,0.438,178,461,0.386,300,630,0.476,0.52,267,316,0.845,50,185,235,277,52,15,147,117,1401
Georges Niang,1783557,AP,27,UTA,72,10,1154,177,405,0.437,124,292,0.425,53,113,0.469,0.59,22,23,0.957,28,148,176,59,25,8,51,116,500
Matt Thomas,1517981,ES,26,TOT,45,0,326,50,127,0.394,27,80,0.338,23,47,0.489,0.5,12,14,0.857,7,37,44,19,4,0,14,18,139
Miye Oni,1517981,ES,23,UTA,54,0,519,35,99,0.354,30,88,0.341,5,11,0.455,0.505,5,6,0.833,23,61,84,28,11,8,16,61,105
Juwan Morgan,1517981,AP,23,UTA,29,0,147,14,30,0.467,4,13,0.308,10,17,0.588,0.533,3,7,0.429,9,19,28,9,4,1,4,21,35
Elijah Hughes,898310,AL,22,UTA,18,0,64,10,30,0.333,8,23,0.348,2,7,0.286,0.467,3,4,0.75,1,8,9,6,1,1,6,1,31
Shaquille Harrison,770433,ES,27,TOT,34,0,333,26,78,0.333,3,16,0.188,23,62,0.371,0.353,18,22,0.818,7,41,48,25,17,5,11,33,73
Ersan İlyasova,754783,AP,33,UTA,17,1,148,21,54,0.389,18,41,0.439,3,13,0.231,0.556,5,5,1.0,7,22,29,4,10,3,8,29,65
Kristaps Porziņģis,29467800,P,25,DAL,43,43,1327,325,683,0.476,97,258,0.376,228,425,0.536,0.547,118,138,0.855,82,299,381,68,20,58,51,115,865
Dwight Powell,11080125,P,29,DAL,58,19,966,120,194,0.619,5,21,0.238,115,173,0.665,0.631,97,124,0.782,80,154,234,63,36,30,40,135,342
Josh Richardson,10865952,ES,27,DAL,59,56,1790,264,618,0.427,88,267,0.33,176,351,0.501,0.498,99,108,0.917,51,144,195,153,61,24,79,130,715
Maxi Kleber,8325000,AP,29,DAL,50,40,1341,116,275,0.422,87,212,0.41,29,63,0.46,0.58,34,37,0.919,47,213,260,68,24,35,30,105,353
Luka Dončić,8049360,BA,21,DAL,66,66,2262,647,1351,0.479,192,548,0.35,455,803,0.567,0.55,344,471,0.73,54,473,527,567,64,36,281,152,1830
Willie Cauley-Stein,4100000,P,27,DAL,53,16,906,115,182,0.632,1,11,0.091,114,171,0.667,0.635,49,78,0.628,66,170,236,35,21,43,29,129,280
Dorian Finney-Smith,4000000,AP,27,DAL,60,60,1921,220,466,0.472,119,302,0.394,101,164,0.616,0.6,31,41,0.756,98,228,326,102,52,25,48,138,590
Nicolò Melli,3897436,AP,30,TOT,45,4,566,46,141,0.326,23,85,0.271,23,56,0.411,0.408,19,25,0.76,29,93,122,44,14,3,12,58,134
Boban Marjanović,3500000,P,32,DAL,33,3,271,62,122,0.508,1,8,0.125,61,114,0.535,0.512,31,38,0.816,47,81,128,10,2,6,12,29,156
Trey Burke,3000000,BA,28,DAL,62,1,911,151,353,0.428,58,164,0.354,93,189,0.492,0.51,51,57,0.895,10,44,54,81,36,7,33,64,411
Josh Green,2816760,ES,20,DAL,39,5,445,42,93,0.452,4,25,0.16,38,68,0.559,0.473,13,23,0.565,28,50,78,28,16,3,17,35,101
Jalen Brunson,1663861,BA,24,DAL,68,12,1697,328,627,0.523,81,200,0.405,247,427,0.578,0.588,120,151,0.795,27,204,231,239,35,1,80,109,857
Tyrell Terry,1289846,BA,20,DAL,11,0,56,5,16,0.313,0,7,0.0,5,9,0.556,0.313,1,3,0.333,0,6,6,6,5,0,2,2,11
Steven Adams,29592695,P,27,NOP,58,58,1605,189,308,0.614,0,3,0.0,189,305,0.62,0.614,60,135,0.444,213,301,514,111,54,38,78,113,438
Brandon Ingram,27285000,AL,23,NOP,61,61,2093,513,1101,0.466,143,375,0.381,370,726,0.51,0.531,281,320,0.878,34,265,299,296,42,36,154,124,1450
Eric Bledsoe,16875000,ES,31,NOP,71,70,2111,307,730,0.421,121,355,0.341,186,375,0.496,0.503,134,195,0.687,29,215,244,268,55,24,114,112,869
James Johnson,16047100,AP,33,TOT,51,12,1043,146,327,0.446,31,120,0.258,115,207,0.556,0.494,45,76,0.592,32,145,177,98,42,42,55,120,368
Lonzo Ball,11003782,BA,23,NOP,55,55,1747,290,700,0.414,172,455,0.378,118,245,0.482,0.537,50,64,0.781,33,230,263,316,82,31,123,103,802
Zion Williamson,10245480,AP,20,NOP,61,61,2026,634,1037,0.611,10,34,0.294,624,1003,0.622,0.616,369,529,0.698,167,274,441,226,57,39,167,135,1647
Jaxson Hayes,5105160,P,20,NOP,60,3,964,175,280,0.625,6,14,0.429,169,266,0.635,0.636,93,120,0.775,92,165,257,35,25,38,39,101,449
Josh Hart,3491159,AL,25,NOP,47,4,1349,151,344,0.439,63,193,0.326,88,151,0.583,0.531,69,89,0.775,53,324,377,109,38,12,49,111,434
Nickeil Alexander-Walker,3113160,ES,22,NOP,46,13,1007,192,458,0.419,76,219,0.347,116,239,0.485,0.502,48,66,0.727,13,131,144,102,47,22,69,88,508
Wes Iwundu,1678854,AL,26,TOT,41,4,539,34,102,0.333,5,41,0.122,29,61,0.475,0.358,26,31,0.839,15,75,90,18,15,4,19,49,99
Willy Hernangómez,1620564,P,26,NOP,47,12,846,151,268,0.563,1,10,0.1,150,258,0.581,0.565,62,93,0.667,117,217,334,50,22,23,34,68,365
Wenyen Gabriel,1620564,AP,23,NOP,21,0,241,24,60,0.4,13,32,0.406,11,28,0.393,0.508,11,17,0.647,20,34,54,11,9,8,15,32,72
Sindarius Thornwell,943480,ES,26,TOT,21,1,217,15,46,0.326,7,23,0.304,8,23,0.348,0.402,4,8,0.5,3,15,18,21,13,2,7,15,41
Naji Marshall,120000,AL,23,NOP,32,10,700,82,209,0.392,29,83,0.349,53,126,0.421,0.462,53,75,0.707,15,133,148,88,26,10,38,58,246
Isaiah Thomas,110998,BA,31,NOP,3,0,48,9,27,0.333,3,12,0.25,6,15,0.4,0.389,2,2,1.0,1,3,4,5,1,0,6,3,23
Al Horford,27500000,P,34,OKC,28,28,782,162,360,0.45,56,152,0.368,106,208,0.51,0.528,18,22,0.818,29,159,188,94,25,26,29,48,398
Darius Miller,7000000,AL,30,OKC,18,0,197,22,48,0.458,17,42,0.405,5,6,0.833,0.635,12,12,1.0,2,22,24,21,13,5,8,13,73
Justin Jackson,5029650,AL,25,TOT,34,3,577,89,221,0.403,36,117,0.308,53,104,0.51,0.484,31,37,0.838,16,61,77,52,15,2,32,32,245
Shai Gilgeous-Alexander,4141320,ES,22,OKC,35,35,1180,287,565,0.508,71,170,0.418,216,395,0.547,0.571,185,229,0.808,19,147,166,207,27,23,106,70,830
Gabriel Deck,3870370,AP,25,OKC,10,0,212,32,67,0.478,2,15,0.133,30,52,0.577,0.493,18,22,0.818,16,24,40,24,8,0,6,9,84
Tony Bradley,3542060,P,23,TOT,42,8,684,131,197,0.665,0,3,0.0,131,194,0.675,0.665,38,55,0.691,85,154,239,37,15,30,33,61,300
Austin Rivers,3500000,ES,28,TOT,36,7,845,104,245,0.424,55,149,0.369,49,96,0.51,0.537,22,31,0.71,8,74,82,81,30,2,36,64,285
Austin Rivers,299694,ES,28,TOT,36,7,845,104,245,0.424,55,149,0.369,49,96,0.51,0.537,22,31,0.71,8,74,82,81,30,2,36,64,285
Aleksej Pokusevski,2964840,AP,19,OKC,45,28,1090,139,408,0.341,58,207,0.28,81,201,0.403,0.412,31,42,0.738,30,182,212,97,20,42,99,58,367
Darius Bazley,2399160,AP,20,OKC,55,55,1714,273,690,0.396,83,286,0.29,190,404,0.47,0.456,125,178,0.702,51,345,396,99,29,25,122,60,754
Ty Jerome,2303040,ES,23,OKC,33,1,788,128,287,0.446,71,168,0.423,57,119,0.479,0.57,26,34,0.765,10,81,91,120,20,6,47,61,353
Mike Muscala,2283034,P,29,OKC,35,0,645,119,267,0.446,68,184,0.37,51,83,0.614,0.573,33,36,0.917,19,113,132,28,8,11,21,54,339
Kenrich Williams,2000000,AP,26,OKC,66,13,1426,219,411,0.533,52,117,0.444,167,294,0.568,0.596,36,63,0.571,84,189,273,152,55,17,76,143,526
Théo Maledon,2000000,BA,19,OKC,65,49,1778,226,614,0.368,105,313,0.335,121,301,0.402,0.454,101,135,0.748,25,186,211,227,56,11,141,126,658
Svi Mykhailiuk,1663861,AL,23,TOT,66,14,1324,208,506,0.411,105,314,0.334,103,192,0.536,0.515,38,50,0.76,24,139,163,110,51,12,88,63,559
Luguentz Dort,1517981,ES,21,OKC,52,52,1543,247,639,0.387,113,329,0.343,134,310,0.432,0.475,122,164,0.744,38,151,189,88,45,19,79,134,729
Isaiah Roby,1517981,AP,22,OKC,61,34,1425,207,429,0.483,32,109,0.294,175,320,0.547,0.52,87,117,0.744,89,252,341,107,52,37,113,162,533
Patrick Patterson,737067,AP,31,LAC,38,5,582,72,165,0.436,40,112,0.357,32,53,0.604,0.558,13,17,0.765,19,56,75,29,14,8,11,45,197
Patrick Patterson,3077704,AP,31,LAC,38,5,582,72,165,0.436,40,112,0.357,32,53,0.604,0.558,13,17,0.765,19,56,75,29,14,8,11,45,197
Frank Jackson,250000,BA,22,DET,40,6,738,134,293,0.457,61,150,0.407,73,143,0.51,0.561,61,75,0.813,15,71,86,36,15,1,34,53,390
Justin Robinson,198040,BA,23,OKC,9,0,88,7,21,0.333,4,14,0.286,3,7,0.429,0.429,3,5,0.6,1,6,7,9,3,0,2,10,21
Karl-Anthony Towns,29467800,P,25,MIN,50,50,1689,425,875,0.486,122,315,0.387,303,560,0.541,0.555,267,311,0.859,133,396,529,225,39,57,160,186,1239
D'Angelo Russell,28649250,BA,24,MIN,42,26,1196,281,652,0.431,120,310,0.387,161,342,0.471,0.523,114,149,0.765,16,95,111,244,45,18,112,68,796
Ricky Rubio,17000000,BA,30,MIN,68,51,1772,193,498,0.388,66,214,0.308,127,284,0.447,0.454,130,150,0.867,28,195,223,433,98,4,111,139,582
Malik Beasley,13425895,ES,24,MIN,37,36,1214,264,600,0.44,128,321,0.399,136,279,0.487,0.547,68,80,0.85,28,134,162,88,30,7,60,62,724
Anthony Edwards,9757440,ES,19,MIN,72,55,2314,505,1211,0.417,171,520,0.329,334,691,0.483,0.488,211,272,0.776,59,277,336,211,82,36,160,129,1392
Jarrett Culver,6104280,ES,21,MIN,34,7,499,69,168,0.411,13,53,0.245,56,115,0.487,0.449,29,48,0.604,34,70,104,24,17,9,28,58,180
Juancho Hernangómez,5718000,AP,25,MIN,52,6,900,130,299,0.435,55,168,0.327,75,131,0.573,0.527,60,97,0.619,45,160,205,35,19,7,27,52,375
Jake Layman,3761085,AL,26,MIN,45,11,627,91,184,0.495,23,78,0.295,68,106,0.642,0.557,26,37,0.703,13,54,67,28,29,19,26,44,231
Josh Okogie,2651040,ES,22,MIN,59,37,1197,102,254,0.402,29,108,0.269,73,146,0.5,0.459,83,108,0.769,63,93,156,63,54,28,43,123,316
Jaden McDaniels,1964760,AP,20,MIN,63,27,1511,164,367,0.447,72,198,0.364,92,169,0.544,0.545,27,45,0.6,52,180,232,71,35,60,47,172,427
Jarred Vanderbilt,1663861,AP,21,MIN,64,30,1139,143,236,0.606,1,5,0.2,142,231,0.615,0.608,57,102,0.559,118,250,368,76,64,46,53,123,344
Jaylen Nowell,1517981,ES,21,MIN,42,0,759,142,335,0.424,50,150,0.333,92,185,0.497,0.499,45,55,0.818,19,76,95,62,22,12,28,72,379
Naz Reid,1517981,P,21,MIN,70,15,1347,304,581,0.523,61,174,0.351,243,407,0.597,0.576,115,166,0.693,82,240,322,72,34,76,69,179,784
LeBron James,39219566,BA,36,LAL,45,45,1504,422,823,0.513,104,285,0.365,318,538,0.591,0.576,178,255,0.698,29,317,346,350,48,25,168,70,1126
Anthony Davis,32742000,AP,27,LAL,36,36,1162,301,613,0.491,26,100,0.26,275,513,0.536,0.512,158,214,0.738,62,224,286,110,45,59,74,60,786
Dennis Schröder,16000000,ES,27,LAL,61,61,1956,332,760,0.437,71,212,0.335,261,548,0.476,0.484,206,243,0.848,30,181,211,351,70,13,163,159,941
Kentavious Caldwell-Pope,12073020,ES,27,LAL,67,67,1902,218,506,0.431,120,293,0.41,98,213,0.46,0.549,97,112,0.866,27,152,179,127,62,26,66,114,653
Montrezl Harrell,9258000,P,27,LAL,69,1,1580,375,603,0.622,0,10,0.0,375,593,0.632,0.622,181,256,0.707,158,270,428,73,46,49,74,128,931
Wesley Matthews,3623000,ES,34,LAL,58,10,1130,89,252,0.353,66,197,0.335,23,55,0.418,0.484,35,41,0.854,20,73,93,54,38,17,26,80,279
Kyle Kuzma,3562178,AL,25,LAL,68,32,1954,335,757,0.443,137,380,0.361,198,377,0.525,0.533,67,97,0.691,108,309,417,127,35,41,113,121,874
Alex Caruso,2750000,BA,26,LAL,58,6,1216,133,305,0.436,55,137,0.401,78,168,0.464,0.526,49,76,0.645,31,139,170,160,64,15,76,108,370
Marc Gasol,2564753,P,36,LAL,52,42,993,88,194,0.454,50,122,0.41,38,72,0.528,0.582,36,50,0.72,38,177,215,109,26,58,53,115,262
Quinn Cook,1797183,BA,27,TOT,23,0,157,29,68,0.426,11,26,0.423,18,42,0.429,0.507,7,8,0.875,2,15,17,18,4,1,7,10,76
Quinn Cook,221996,BA,27,TOT,23,0,157,29,68,0.426,11,26,0.423,18,42,0.429,0.507,7,8,0.875,2,15,17,18,4,1,7,10,76
Alfonzo McKinnie,1762796,AL,28,LAL,39,0,258,48,93,0.516,16,39,0.41,32,54,0.593,0.602,10,18,0.556,22,32,54,6,7,0,5,26,122
Markieff Morris,1620564,AP,31,LAL,61,27,1200,153,378,0.405,65,209,0.311,88,169,0.521,0.491,36,50,0.72,48,218,266,73,22,19,54,105,407
Talen Horton-Tucker,1517981,ES,20,LAL,65,4,1304,224,489,0.458,37,131,0.282,187,358,0.522,0.496,100,129,0.775,25,144,169,181,63,21,105,127,585
Jordan Bell,580062,P,26,TOT,6,1,82,7,22,0.318,0,2,0.0,7,20,0.35,0.318,1,2,0.5,7,17,24,7,3,5,4,7,15
Jordan Bell,221996,P,26,TOT,6,1,82,7,22,0.318,0,2,0.0,7,20,0.35,0.318,1,2,0.5,7,17,24,7,3,5,4,7,15
Andre Drummond,554988,P,27,TOT,46,46,1242,282,572,0.493,0,8,0.0,282,564,0.5,0.493,123,205,0.6,166,385,551,94,63,49,124,149,687
Andre Drummond,27957238,P,27,TOT,46,46,1242,282,572,0.493,0,8,0.0,282,564,0.5,0.493,123,205,0.6,166,385,551,94,63,49,124,149,687
Damian Jones,221996,P,25,TOT,39,10,547,70,103,0.68,1,5,0.2,69,98,0.704,0.684,42,58,0.724,36,85,121,29,11,29,26,77,183
Damian Jones,785285,P,25,TOT,39,10,547,70,103,0.68,1,5,0.2,69,98,0.704,0.684,42,58,0.724,36,85,121,29,11,29,26,77,183
Damian Jones,459961,P,25,TOT,39,10,547,70,103,0.68,1,5,0.2,69,98,0.704,0.684,42,58,0.724,36,85,121,29,11,29,26,77,183
Stephen Curry,43006362,BA,32,GSW,63,63,2152,658,1365,0.482,337,801,0.421,321,564,0.569,0.605,362,395,0.916,29,316,345,363,77,8,213,119,2015
Andrew Wiggins,29542010,AP,25,GSW,71,71,2364,505,1058,0.477,140,368,0.38,365,690,0.529,0.543,170,238,0.714,82,265,347,167,67,70,126,159,1320
Draymond Green,22246956,AP,30,GSW,63,63,1982,170,380,0.447,34,126,0.27,136,254,0.535,0.492,70,88,0.795,55,394,449,558,105,52,188,194,444
James Wiseman,8730240,P,19,GSW,39,27,836,191,368,0.519,12,38,0.316,179,330,0.542,0.535,54,86,0.628,55,171,226,26,11,36,60,121,448
Kevon Looney,4821429,P,24,GSW,61,34,1161,108,197,0.548,4,17,0.235,104,180,0.578,0.558,31,48,0.646,117,205,322,119,21,22,37,136,251
Jordan Poole,2063280,ES,21,GSW,51,7,988,205,474,0.432,97,276,0.351,108,198,0.545,0.535,105,119,0.882,15,77,92,99,26,9,51,86,612
Damion Lee,1762796,ES,28,GSW,57,1,1079,128,274,0.467,77,194,0.397,51,80,0.638,0.608,40,44,0.909,22,158,180,73,38,8,30,89,373
Kent Bazemore,1620564,AL,31,GSW,67,18,1333,176,392,0.449,75,184,0.408,101,208,0.486,0.545,54,78,0.692,26,203,229,108,69,33,82,158,481
Mychal Mulder,1517981,BA,26,GSW,60,6,766,119,265,0.449,85,214,0.397,34,51,0.667,0.609,14,22,0.636,8,52,60,26,12,12,16,56,337
Eric Paschall,1517981,AP,24,GSW,40,2,695,148,298,0.497,18,54,0.333,130,244,0.533,0.527,67,94,0.713,28,100,128,51,12,7,43,68,381
Alen Smailagić,1517981,AP,20,GSW,15,1,84,11,27,0.407,4,10,0.4,7,17,0.412,0.481,2,6,0.333,6,10,16,4,3,5,5,11,28
Juan Toscano-Anderson,358295,ES,27,GSW,53,16,1107,121,209,0.579,37,92,0.402,84,117,0.718,0.667,22,31,0.71,29,205,234,150,41,26,61,111,301
Paul George,35450412,AL,30,LAC,54,54,1821,445,953,0.467,171,416,0.411,274,537,0.51,0.557,198,228,0.868,45,314,359,280,62,24,179,132,1259
Kawhi Leonard,34379100,AL,29,LAC,52,52,1773,465,908,0.512,101,254,0.398,364,654,0.557,0.568,261,295,0.885,55,282,337,269,81,21,105,82,1292
Marcus Morris,14883721,AP,31,LAC,57,29,1502,276,584,0.473,140,296,0.473,136,288,0.472,0.592,73,89,0.82,35,199,234,58,34,15,57,117,765
Patrick Beverley,13333333,BA,32,LAC,37,34,832,93,220,0.423,56,141,0.397,37,79,0.468,0.55,36,45,0.8,29,90,119,76,29,28,34,108,278
Serge Ibaka,9258000,P,31,LAC,41,39,955,186,365,0.51,39,115,0.339,147,250,0.588,0.563,43,53,0.811,73,202,275,74,9,47,44,76,454
Rajon Rondo,8250000,BA,34,TOT,45,3,770,95,215,0.442,36,89,0.404,59,126,0.468,0.526,16,17,0.941,18,92,110,199,37,4,79,53,242
Ivica Zubac,7000000,P,23,LAC,72,33,1609,257,394,0.652,1,4,0.25,256,390,0.656,0.654,135,171,0.789,189,330,519,90,24,62,81,187,650
Luke Kennard,5273826,ES,24,LAC,63,17,1232,197,414,0.476,100,224,0.446,97,190,0.511,0.597,26,31,0.839,15,146,161,104,23,9,48,91,520
Reggie Jackson,1620564,ES,30,LAC,67,43,1544,263,585,0.45,122,282,0.433,141,303,0.465,0.554,67,82,0.817,24,168,192,205,41,7,74,127,715
Nicolas Batum,1620564,AL,32,LAC,67,38,1835,191,412,0.464,110,272,0.404,81,140,0.579,0.597,48,58,0.828,50,266,316,148,69,37,53,102,540
Nicolas Batum,8856969,AL,32,LAC,67,38,1835,191,412,0.464,110,272,0.404,81,140,0.579,0.597,48,58,0.828,50,266,316,148,69,37,53,102,540
Terance Mann,1517984,ES,24,LAC,67,10,1263,178,350,0.509,38,91,0.418,140,259,0.541,0.563,78,94,0.83,56,186,242,104,29,13,40,126,472
Daniel Oturu,898310,P,21,LAC,30,0,161,22,52,0.423,1,5,0.2,21,47,0.447,0.433,9,12,0.75,21,27,48,10,4,7,9,24,54
Yogi Ferrell,325167,BA,27,TOT,10,0,136,20,57,0.351,9,28,0.321,11,29,0.379,0.43,7,9,0.778,5,14,19,22,7,3,3,11,56
Yogi Ferrell,110998,BA,27,TOT,10,0,136,20,57,0.351,9,28,0.321,11,29,0.379,0.43,7,9,0.778,5,14,19,22,7,3,3,11,56
Chris Paul,41358814,BA,35,PHO,70,70,2199,439,879,0.499,102,258,0.395,337,621,0.543,0.557,169,181,0.934,25,287,312,622,99,19,156,166,1149
Devin Booker,29467800,ES,24,PHO,67,67,2270,623,1287,0.484,126,371,0.34,497,916,0.543,0.533,340,392,0.867,34,247,281,289,53,16,207,181,1712
Deandre Ayton,10018200,P,22,PHO,69,69,2115,430,687,0.626,4,20,0.2,426,667,0.639,0.629,133,173,0.769,228,499,727,99,41,81,103,196,997
Jae Crowder,9258000,AP,30,PHO,60,42,1648,199,492,0.404,148,380,0.389,51,112,0.455,0.555,57,75,0.76,32,250,282,127,48,27,55,125,603
Dario Šarić,9250000,P,26,PHO,50,4,871,153,342,0.447,47,135,0.348,106,207,0.512,0.516,84,99,0.848,46,144,190,65,30,4,57,95,437
Mikal Bridges,4359000,AL,24,PHO,72,72,2348,363,669,0.543,134,315,0.425,229,354,0.647,0.643,110,131,0.84,76,233,309,152,76,63,57,116,970
Jalen Smith,4245720,AP,20,PHO,27,1,156,22,50,0.44,4,17,0.235,18,33,0.545,0.48,5,7,0.714,7,30,37,4,1,5,7,16,53
Cameron Johnson,4235160,AP,24,PHO,60,11,1437,203,483,0.42,117,335,0.349,86,148,0.581,0.541,50,59,0.847,33,166,199,86,37,16,40,85,573
Jevon Carter,3925000,BA,25,PHO,60,1,717,94,223,0.422,56,151,0.371,38,72,0.528,0.547,4,7,0.571,16,76,92,71,29,9,16,56,248
Cameron Payne,1977011,BA,26,PHO,60,1,1079,191,395,0.484,73,166,0.44,118,229,0.515,0.576,50,56,0.893,16,128,144,217,36,16,60,97,505
Abdel Nader,1752950,AL,27,PHO,24,0,355,57,116,0.491,18,43,0.419,39,73,0.534,0.569,28,37,0.757,7,55,62,19,10,9,19,34,160
Langston Galloway,1620564,ES,29,PHO,40,0,438,66,147,0.449,36,85,0.424,30,62,0.484,0.571,22,23,0.957,7,35,42,26,8,0,13,25,190
Frank Kaminsky,1620564,P,27,PHO,47,13,715,121,257,0.471,31,85,0.365,90,172,0.523,0.531,37,60,0.617,36,152,188,79,14,17,22,70,310
E'Twaun Moore,1620564,ES,31,PHO,27,1,389,55,121,0.455,11,35,0.314,44,86,0.512,0.5,12,14,0.857,14,31,45,40,15,5,23,32,133
Torrey Craig,1620564,AL,30,TOT,50,8,803,109,227,0.48,39,106,0.368,70,121,0.579,0.566,17,22,0.773,57,140,197,49,28,26,25,83,274
Buddy Hield,24701834,ES,28,SAC,71,71,2433,403,992,0.406,282,721,0.391,121,271,0.446,0.548,88,104,0.846,29,305,334,257,63,30,130,175,1176
Harrison Barnes,22215909,AP,28,SAC,58,58,2102,319,642,0.497,100,256,0.391,219,386,0.567,0.575,195,235,0.83,64,321,385,201,43,11,93,75,933
Delon Wright,9000000,BA,28,TOT,63,39,1748,240,518,0.463,64,172,0.372,176,346,0.509,0.525,101,126,0.802,65,204,269,278,101,30,83,75,645
De'Aaron Fox,8099627,BA,23,SAC,58,58,2036,529,1110,0.477,103,320,0.322,426,790,0.539,0.523,300,417,0.719,33,170,203,417,87,27,174,170,1461
Jabari Parker,6500000,AP,25,TOT,13,0,165,30,55,0.545,2,11,0.182,28,44,0.636,0.564,10,13,0.769,10,32,42,11,1,5,10,13,72
Jabari Parker,430729,AP,25,TOT,13,0,165,30,55,0.545,2,11,0.182,28,44,0.636,0.564,10,13,0.769,10,32,42,11,1,5,10,13,72
Richaun Holmes,5005350,P,27,SAC,61,61,1782,366,575,0.637,2,11,0.182,364,564,0.645,0.638,135,170,0.794,144,360,504,101,39,96,75,213,869
Tyrese Haliburton,3831840,BA,20,SAC,58,20,1746,292,619,0.472,121,296,0.409,171,323,0.529,0.569,48,56,0.857,39,134,173,309,77,28,92,83,753
Maurice Harkless,3623000,AP,27,TOT,37,23,772,69,165,0.418,23,84,0.274,46,81,0.568,0.488,33,43,0.767,13,76,89,44,30,20,22,86,194
Mfiondu Kabengele,2075880,AP,23,TOT,39,0,280,33,89,0.371,13,50,0.26,20,39,0.513,0.444,16,20,0.8,12,48,60,17,8,13,15,36,95
Mfiondu Kabengele,356473,AP,23,TOT,39,0,280,33,89,0.371,13,50,0.26,20,39,0.513,0.444,16,20,0.8,12,48,60,17,8,13,15,36,95
Hassan Whiteside,1620564,P,31,SAC,36,4,546,126,224,0.563,0,1,0.0,126,223,0.565,0.563,41,79,0.519,61,154,215,20,9,46,40,73,293
Terence Davis,1517981,ES,23,TOT,61,4,1074,195,456,0.428,98,267,0.367,97,189,0.513,0.535,45,55,0.818,20,134,154,83,44,14,63,97,533
Justin James,1517981,AL,24,SAC,36,0,310,52,111,0.468,14,38,0.368,38,73,0.521,0.532,21,36,0.583,9,21,30,22,8,3,15,23,139
Chris Silva,1517981,AP,24,TOT,15,0,92,10,16,0.625,1,1,1.0,9,15,0.6,0.656,11,15,0.733,7,20,27,6,1,6,10,24,32
Jahmi'us Ramsey,1000000,ES,19,SAC,13,0,94,15,38,0.395,5,19,0.263,10,19,0.526,0.461,5,5,1.0,2,8,10,6,4,1,3,8,40
Chimezie Metu,750000,P,23,SAC,36,6,488,91,179,0.508,13,37,0.351,78,142,0.549,0.545,31,43,0.721,31,81,112,28,14,18,29,59,226
Jonas Valančiūnas,15000000,P,28,MEM,62,61,1755,440,743,0.592,21,57,0.368,419,686,0.611,0.606,157,203,0.773,253,523,776,112,35,57,100,179,1058
Justise Winslow,13000000,AL,24,MEM,26,1,507,74,210,0.352,10,54,0.185,64,156,0.41,0.376,20,35,0.571,18,100,118,50,15,12,37,47,178
Dillon Brooks,11400000,AL,25,MEM,67,67,1997,432,1031,0.419,128,372,0.344,304,659,0.461,0.481,159,195,0.815,53,143,196,157,78,26,119,237,1151
De'Anthony Melton,9571712,BA,22,MEM,52,1,1045,172,393,0.438,87,211,0.412,85,182,0.467,0.548,41,51,0.804,30,131,161,132,60,31,66,85,472
Kyle Anderson,9505100,AP,27,MEM,69,69,1887,308,658,0.468,94,261,0.36,214,397,0.539,0.54,144,184,0.783,52,344,396,250,84,57,86,120,854
Ja Morant,9166800,BA,21,MEM,63,63,2053,430,957,0.449,73,241,0.303,357,716,0.499,0.487,271,372,0.728,59,193,252,465,57,13,203,87,1204
Tyus Jones,7965100,BA,24,MEM,70,9,1222,178,413,0.431,45,140,0.321,133,273,0.487,0.485,41,45,0.911,21,119,140,259,64,6,48,31,442
Brandon Clarke,2602920,AP,24,MEM,59,16,1415,256,495,0.517,20,77,0.26,236,418,0.565,0.537,78,113,0.69,97,231,328,95,60,51,33,84,610
Grayson Allen,2545320,ES,25,MEM,50,38,1259,173,414,0.418,107,274,0.391,66,140,0.471,0.547,79,91,0.868,19,141,160,108,46,8,48,71,532
John Konchar,2100000,ES,24,MEM,43,0,575,69,138,0.5,21,56,0.375,48,82,0.585,0.576,25,30,0.833,35,93,128,47,30,9,18,40,184
Desmond Bane,1936440,ES,22,MEM,68,17,1519,234,499,0.469,117,271,0.432,117,228,0.513,0.586,40,49,0.816,31,179,210,118,41,16,59,125,625
Jontay Porter,1900000,AP,21,MEM,11,0,54,8,15,0.533,3,8,0.375,5,7,0.714,0.633,3,5,0.6,4,10,14,1,3,1,7,12,22
Tim Frazier,518612,BA,30,MEM,5,0,62,3,20,0.15,0,8,0.0,3,12,0.25,0.15,2,6,0.333,0,8,8,16,2,1,4,7,8
Nikola Jokić,29542010,P,25,DEN,72,72,2488,732,1293,0.566,92,237,0.388,640,1056,0.606,0.602,342,394,0.868,205,575,780,599,95,48,222,192,1898
Jamal Murray,27285000,BA,23,DEN,48,48,1704,378,792,0.477,129,316,0.408,249,476,0.523,0.559,133,153,0.869,37,157,194,231,64,13,108,95,1018
Aaron Gordon,18136364,AP,25,TOT,50,50,1384,231,499,0.463,59,176,0.335,172,323,0.533,0.522,97,149,0.651,77,207,284,161,33,34,97,89,618
Will Barton,13723214,AL,30,DEN,56,52,1736,259,608,0.426,98,257,0.381,161,351,0.459,0.507,95,121,0.785,39,187,226,181,50,23,96,95,711
Paul Millsap,10000000,AP,35,DEN,56,36,1162,191,401,0.476,49,143,0.343,142,258,0.55,0.537,71,98,0.724,76,186,262,98,51,36,51,111,502
JaMychal Green,7199760,AP,30,DEN,58,5,1120,173,374,0.463,79,198,0.399,94,176,0.534,0.568,46,57,0.807,85,192,277,53,26,22,53,144,471
JaVale McGee,4200000,P,33,TOT,46,2,678,144,282,0.511,5,24,0.208,139,258,0.539,0.52,44,67,0.657,77,162,239,39,19,54,60,121,337
Facundo Campazzo,3100000,BA,29,DEN,65,19,1425,120,315,0.381,76,216,0.352,44,99,0.444,0.502,80,91,0.879,22,112,134,232,79,14,73,132,396
Zeke Nnaji,2379840,AP,20,DEN,42,1,397,50,104,0.481,24,59,0.407,26,45,0.578,0.596,12,15,0.8,14,51,65,10,8,4,7,29,136
Bol Bol,2058240,AP,21,DEN,32,2,160,25,58,0.431,9,24,0.375,16,34,0.471,0.509,10,15,0.667,0,24,24,7,3,10,13,14,69
Gary Clark,2000000,AP,26,TOT,39,11,654,40,132,0.303,31,108,0.287,9,24,0.375,0.42,8,10,0.8,33,82,115,31,13,7,17,35,119
PJ Dozier,1762796,ES,24,DEN,50,6,1088,148,355,0.417,47,149,0.315,101,206,0.49,0.483,42,66,0.636,35,147,182,92,31,22,46,86,385
Monte Morris,1723707,BA,25,DEN,47,13,1196,186,387,0.481,51,134,0.381,135,253,0.534,0.547,58,73,0.795,11,85,96,150,34,13,34,48,481
Vlatko Čančar,1517981,AP,23,DEN,41,1,281,33,72,0.458,9,33,0.273,24,39,0.615,0.521,10,13,0.769,11,39,50,14,11,2,14,18,85
Blake Griffin,32670565,AP,31,TOT,46,30,1186,174,411,0.423,70,205,0.341,104,206,0.505,0.509,87,117,0.744,35,190,225,140,32,15,62,111,505
Blake Griffin,776983,AP,31,TOT,46,30,1186,174,411,0.423,70,205,0.341,104,206,0.505,0.509,87,117,0.744,35,190,225,140,32,15,62,111,505
Jerami Grant,19050000,AL,26,DET,54,54,1829,400,932,0.429,115,329,0.35,285,603,0.473,0.491,290,343,0.845,35,215,250,152,35,58,109,125,1205
Cory Joseph,12600000,BA,29,TOT,63,13,1446,200,426,0.469,45,132,0.341,155,294,0.527,0.522,72,88,0.818,35,124,159,213,61,18,79,139,517
Mason Plumlee,8000000,P,30,DET,56,56,1499,234,381,0.614,0,7,0.0,234,374,0.626,0.614,113,169,0.669,145,374,519,202,43,50,105,186,581
Killian Hayes,5307120,BA,19,DET,26,18,670,71,201,0.353,20,72,0.278,51,129,0.395,0.403,14,17,0.824,6,63,69,138,27,10,83,57,176
Rodney McGruder,5192307,ES,29,DET,16,2,194,37,70,0.529,11,24,0.458,26,46,0.565,0.607,6,8,0.75,8,14,22,16,8,1,7,12,91
Josh Jackson,4767000,ES,23,DET,62,25,1560,296,707,0.419,77,257,0.3,219,450,0.487,0.473,159,218,0.729,57,197,254,143,53,47,142,178,828
Sekou Doumbouya,3449400,AP,20,DET,56,11,869,107,282,0.379,26,115,0.226,81,167,0.485,0.426,45,64,0.703,39,104,143,47,24,9,44,94,285
Isaiah Stewart,3121080,P,19,DET,68,14,1455,226,409,0.553,21,63,0.333,205,346,0.592,0.578,64,92,0.696,159,294,453,59,39,86,67,184,537
Dewayne Dedmon,2866667,P,31,MIA,16,0,210,46,65,0.708,1,5,0.2,45,60,0.75,0.715,20,27,0.741,28,58,86,12,9,6,13,36,113
Dewayne Dedmon,432890,P,31,MIA,16,0,210,46,65,0.708,1,5,0.2,45,60,0.75,0.715,20,27,0.741,28,58,86,12,9,6,13,36,113
Saddiq Bey,2689920,AL,21,DET,70,53,1909,279,691,0.404,175,460,0.38,104,231,0.45,0.53,124,147,0.844,43,275,318,95,52,14,60,110,857
Wayne Ellington,2564753,ES,33,DET,46,31,1012,149,338,0.441,116,275,0.422,33,63,0.524,0.612,28,35,0.8,12,73,85,67,18,9,33,59,442
Wayne Ellington,1000000,ES,33,DET,46,31,1012,149,338,0.441,116,275,0.422,33,63,0.524,0.612,28,35,0.8,12,73,85,67,18,9,33,59,442
Jahlil Okafor,1882867,P,25,DET,27,2,347,63,102,0.618,2,9,0.222,61,93,0.656,0.627,17,24,0.708,23,43,66,13,6,5,21,39,145
Hamidou Diallo,1663861,AL,22,TOT,52,9,1226,224,470,0.477,28,82,0.341,196,388,0.505,0.506,128,200,0.64,59,213,272,101,41,24,76,134,604
Deividas Sirvydis,898310,ES,20,DET,20,0,133,14,40,0.35,10,28,0.357,4,12,0.333,0.475,3,6,0.5,0,29,29,5,2,0,5,9,41
Tyler Cook,594121,AP,23,TOT,32,1,438,69,103,0.67,1,2,0.5,68,101,0.673,0.675,17,35,0.486,28,67,95,17,8,2,21,35,156
Tyler Cook,99020,AP,23,TOT,32,1,438,69,103,0.67,1,2,0.5,68,101,0.673,0.675,17,35,0.486,28,67,95,17,8,2,21,35,156
Gordon Hayward,28500000,AL,30,CHO,44,44,1496,311,658,0.473,85,205,0.415,226,453,0.499,0.537,156,185,0.843,37,221,258,181,52,14,91,74,863
Terry Rozier,18900000,ES,26,CHO,69,69,2383,510,1134,0.45,222,571,0.389,288,563,0.512,0.548,165,202,0.817,47,255,302,293,87,26,128,119,1407
Cody Zeller,15415730,P,28,CHO,48,21,1005,181,324,0.559,4,28,0.143,177,296,0.598,0.565,85,119,0.714,119,209,328,86,27,17,51,121,451
LaMelo Ball,7839960,BA,19,CHO,51,31,1469,293,672,0.436,92,261,0.352,201,411,0.489,0.504,125,165,0.758,63,239,302,313,81,18,145,136,803
Malik Monk,5345687,ES,22,CHO,42,0,878,173,399,0.434,85,212,0.401,88,187,0.471,0.54,59,72,0.819,14,87,101,87,19,4,55,47,490
P.J. Washington,4023600,AP,22,CHO,64,61,1954,302,686,0.44,112,290,0.386,190,396,0.48,0.522,108,145,0.745,93,325,418,161,69,79,128,171,824
Miles Bridges,3934320,AP,22,CHO,66,19,1932,313,622,0.503,116,290,0.4,197,332,0.593,0.596,98,113,0.867,81,316,397,147,44,52,106,143,840
Bismack Biyombo,3500000,P,28,CHO,66,36,1349,142,242,0.587,0,1,0.0,142,241,0.589,0.587,47,105,0.448,137,210,347,81,17,74,71,141,331
Brad Wanamaker,2250000,BA,31,TOT,61,0,1053,115,299,0.385,16,85,0.188,99,214,0.463,0.411,90,101,0.891,18,87,105,174,43,11,71,94,336
Devonte' Graham,1663861,BA,25,CHO,55,44,1659,252,669,0.377,179,477,0.375,73,192,0.38,0.51,133,158,0.842,22,126,148,295,48,6,84,77,816
Caleb Martin,1517981,AL,25,CHO,53,3,818,96,256,0.375,31,125,0.248,65,131,0.496,0.436,41,64,0.641,31,110,141,67,37,12,33,62,264
Cody Martin,1517981,AL,25,CHO,52,10,849,83,188,0.441,16,58,0.276,67,130,0.515,0.484,25,43,0.581,52,109,161,86,37,12,40,52,207
Jalen McDaniels,1517981,AL,23,CHO,47,18,904,133,284,0.468,35,105,0.333,98,179,0.547,0.53,45,64,0.703,45,124,169,53,28,19,45,95,346
Nick Richards,1000000,AP,23,CHO,18,0,63,4,9,0.444,0,1,0.0,4,8,0.5,0.444,7,11,0.636,4,7,11,2,0,0,3,7,15
Gary Harris,19160714,ES,26,TOT,39,38,1080,138,345,0.4,48,141,0.34,90,204,0.441,0.47,64,78,0.821,21,58,79,78,28,11,37,71,388
Terrence Ross,13500000,ES,29,ORL,46,2,1347,254,616,0.412,89,264,0.337,165,352,0.469,0.485,120,138,0.87,15,143,158,108,47,21,74,88,717
Markelle Fultz,12288697,BA,22,ORL,8,8,215,41,104,0.394,4,16,0.25,37,88,0.42,0.413,17,19,0.895,5,20,25,43,8,2,18,18,103
Michael Carter-Williams,3300000,ES,29,ORL,31,25,800,105,270,0.389,15,61,0.246,90,209,0.431,0.417,49,80,0.613,39,100,139,129,25,17,69,81,274
Cole Anthony,3285120,BA,20,ORL,47,34,1273,219,552,0.397,58,172,0.337,161,380,0.424,0.449,109,131,0.832,38,183,221,192,30,18,106,98,605
Chuma Okeke,3121080,AP,22,ORL,45,19,1133,135,324,0.417,49,141,0.348,86,183,0.47,0.492,30,40,0.75,42,139,181,101,48,22,38,48,349
Khem Birch,2586036,P,28,TOT,67,22,1529,189,380,0.497,13,52,0.25,176,328,0.537,0.514,91,129,0.705,174,213,387,89,48,50,44,113,482
Khem Birch,410691,P,28,TOT,67,22,1529,189,380,0.497,13,52,0.25,176,328,0.537,0.514,91,129,0.705,174,213,387,89,48,50,44,113,482
R.J. Hampton,2193480,ES,19,TOT,51,1,888,136,313,0.435,27,87,0.31,109,226,0.482,0.478,55,82,0.671,29,150,179,87,21,10,53,61,354
Dwayne Bacon,1678854,ES,25,ORL,72,50,1853,292,726,0.402,59,207,0.285,233,519,0.449,0.443,145,176,0.824,31,193,224,93,45,5,46,103,788
Jeff Teague,1620564,BA,32,TOT,55,7,950,123,284,0.433,36,82,0.439,87,202,0.431,0.496,89,105,0.848,15,73,88,132,34,12,64,56,371
Jeff Teague,510589,BA,32,TOT,55,7,950,123,284,0.433,36,82,0.439,87,202,0.431,0.496,89,105,0.848,15,73,88,132,34,12,64,56,371
Moritz Wagner,221995,P,23,TOT,45,24,722,104,229,0.454,31,91,0.341,73,138,0.529,0.522,71,87,0.816,27,119,146,50,26,18,43,108,310
Moritz Wagner,2161920,P,23,TOT,45,24,722,104,229,0.454,31,91,0.341,73,138,0.529,0.522,71,87,0.816,27,119,146,50,26,18,43,108,310
Robert Franks,198040,AP,24,ORL,7,0,101,13,28,0.464,5,15,0.333,8,13,0.615,0.554,12,13,0.923,6,8,14,5,3,3,2,8,43
Ignas Brazdeikis,148530,AL,22,TOT,13,0,249,35,83,0.422,11,28,0.393,24,55,0.436,0.488,10,14,0.714,11,34,45,17,4,3,12,22,91
Ignas Brazdeikis,1517981,AL,22,TOT,13,0,249,35,83,0.422,11,28,0.393,24,55,0.436,0.488,10,14,0.714,11,34,45,17,4,3,12,22,91
Devin Cannady,61528,BA,24,ORL,8,0,74,11,28,0.393,6,16,0.375,5,12,0.417,0.5,6,7,0.857,0,5,5,1,5,1,2,9,34
Russell Westbrook,41358814,BA,32,WAS,65,65,2369,544,1238,0.439,86,273,0.315,458,965,0.475,0.474,271,413,0.656,109,641,750,763,89,23,312,190,1445
Bradley Beal,28751774,ES,27,WAS,60,60,2147,670,1382,0.485,130,373,0.349,540,1009,0.535,0.532,408,459,0.889,72,211,283,265,69,22,187,140,1878
Dāvis Bertāns,15000000,AP,28,WAS,57,7,1464,193,478,0.404,169,428,0.395,24,50,0.48,0.581,100,115,0.87,18,150,168,49,33,13,33,136,655
Thomas Bryant,8333333,P,23,WAS,10,10,271,59,91,0.648,9,21,0.429,50,70,0.714,0.698,16,24,0.667,18,43,61,15,4,8,11,31,143
Robin Lopez,7300000,P,32,WAS,71,9,1354,269,425,0.633,5,18,0.278,264,407,0.649,0.639,99,137,0.723,141,131,272,55,15,44,75,109,642
Ish Smith,6000000,BA,32,WAS,44,1,924,129,297,0.434,18,49,0.367,111,248,0.448,0.465,19,33,0.576,22,128,150,172,32,13,41,62,295
Rui Hachimura,4692840,AP,22,WAS,57,57,1797,310,648,0.478,45,137,0.328,265,511,0.519,0.513,124,161,0.77,49,263,312,82,44,7,68,120,789
Deni Avdija,4469160,AL,20,WAS,54,32,1257,130,312,0.417,53,168,0.315,77,144,0.535,0.502,29,45,0.644,22,240,262,63,32,15,33,140,342
Jerome Robinson,3737520,ES,23,WAS,17,6,305,28,95,0.295,11,42,0.262,17,53,0.321,0.353,16,20,0.8,4,34,38,25,12,6,19,31,83
Chandler Hutchison,2443440,AL,24,TOT,25,1,346,39,103,0.379,8,22,0.364,31,81,0.383,0.417,21,25,0.84,6,72,78,17,12,5,20,33,107
Isaac Bonga,1663861,AL,21,WAS,40,8,432,30,81,0.37,13,47,0.277,17,34,0.5,0.451,5,8,0.625,18,48,66,23,11,9,22,63,78
Raul Neto,1620564,BA,28,WAS,64,22,1403,209,447,0.468,64,164,0.39,145,283,0.512,0.539,75,85,0.882,28,128,156,146,73,6,53,109,557
Alex Len,1265372,P,27,TOT,64,42,979,171,278,0.615,8,25,0.32,163,253,0.644,0.629,73,116,0.629,78,182,260,49,20,64,55,127,423
Alex Len,2258000,P,27,TOT,64,42,979,171,278,0.615,8,25,0.32,163,253,0.644,0.629,73,116,0.629,78,182,260,49,20,64,55,127,423
Anthony Gill,898310,AP,28,WAS,26,4,218,30,60,0.5,7,24,0.292,23,36,0.639,0.558,13,16,0.813,16,35,51,11,10,4,8,27,80
Malcolm Brogdon,20700000,BA,28,IND,56,56,1930,444,980,0.453,145,374,0.388,299,606,0.493,0.527,153,177,0.864,58,236,294,329,49,15,115,110,1186
Domantas Sabonis,19800000,AP,24,IND,62,62,2231,484,904,0.535,52,162,0.321,432,742,0.582,0.564,240,328,0.732,150,592,742,415,76,33,213,203,1260
Myles Turner,17500000,P,24,IND,47,47,1455,206,432,0.477,69,206,0.335,137,226,0.606,0.557,111,142,0.782,63,243,306,48,40,159,67,165,592
Caris LeVert,16203704,ES,26,TOT,47,39,1486,359,814,0.441,84,258,0.326,275,556,0.495,0.493,146,180,0.811,33,181,214,245,66,30,102,105,948
T.J. Warren,12000000,AL,27,IND,4,4,117,27,51,0.529,0,7,0.0,27,44,0.614,0.529,8,10,0.8,2,12,14,5,2,0,4,16,62
Jeremy Lamb,10500000,ES,28,IND,36,8,765,120,276,0.435,52,128,0.406,68,148,0.459,0.529,71,75,0.947,25,106,131,53,34,23,22,72,363
Doug McDermott,7333333,AP,29,IND,66,29,1619,354,665,0.532,111,286,0.388,243,379,0.641,0.616,80,98,0.816,60,161,221,85,20,6,53,117,899
Justin Holiday,5720400,ES,31,IND,72,52,2183,258,625,0.413,173,453,0.382,85,172,0.494,0.551,67,85,0.788,32,224,256,119,74,41,54,135,756
T.J. McConnell,3500000,BA,28,IND,69,3,1796,274,490,0.559,15,48,0.313,259,442,0.586,0.574,33,48,0.688,55,201,256,456,128,23,135,113,596
Goga Bitadze,2957520,P,21,IND,45,3,561,83,194,0.428,20,79,0.253,63,115,0.548,0.479,45,61,0.738,60,90,150,37,9,60,17,94,231
Aaron Holiday,2345640,BA,24,IND,66,8,1176,170,436,0.39,67,182,0.368,103,254,0.406,0.467,68,83,0.819,15,74,89,123,46,13,66,94,475
Edmond Sumner,2160000,ES,25,IND,53,24,861,148,282,0.525,35,88,0.398,113,194,0.582,0.587,68,83,0.819,18,76,94,49,33,10,51,88,399
JaKarr Sampson,1620564,AP,27,IND,29,4,316,56,113,0.496,3,15,0.2,53,98,0.541,0.509,19,29,0.655,27,50,77,4,2,14,15,52,134
Jalen Lecque,1517981,BA,20,IND,4,0,12,1,9,0.111,0,1,0.0,1,8,0.125,0.111,3,3,1.0,2,3,5,2,0,0,0,0,5
Oshae Brissett,955493,AL,22,IND,21,16,519,73,151,0.483,33,78,0.423,40,73,0.548,0.593,50,65,0.769,29,86,115,18,19,20,10,32,229
Oshae Brissett,300000,AL,22,IND,21,16,519,73,151,0.483,33,78,0.423,40,73,0.548,0.593,50,65,0.769,29,86,115,18,19,20,10,32,229
Kelan Martin,801900,AL,25,IND,35,0,322,62,138,0.449,24,60,0.4,38,78,0.487,0.536,9,10,0.9,18,60,78,17,10,10,16,35,157
Nikola Vučević,26000000,P,30,TOT,70,70,2348,666,1396,0.477,176,440,0.4,490,956,0.513,0.54,131,156,0.84,146,671,817,269,65,48,126,137,1639
Zach LaVine,19500000,ES,25,CHI,58,58,2034,569,1123,0.507,200,477,0.419,369,646,0.571,0.596,253,298,0.849,36,253,289,282,46,27,203,138,1591
Thaddeus Young,13545000,AP,32,CHI,68,23,1652,370,662,0.559,12,45,0.267,358,617,0.58,0.568,71,113,0.628,168,255,423,291,74,40,137,152,823
Tomáš Satoranský,10000000,ES,29,CHI,58,18,1307,169,329,0.514,42,118,0.356,127,211,0.602,0.578,67,79,0.848,30,112,142,271,40,14,96,89,447
Al-Farouq Aminu,9720900,AP,30,TOT,23,14,434,38,99,0.384,8,37,0.216,30,62,0.484,0.424,18,22,0.818,22,88,110,31,19,9,28,29,102
Cristiano Felício,7529020,P,28,CHI,18,0,84,7,13,0.538,0,2,0.0,7,11,0.636,0.538,9,16,0.563,10,16,26,9,4,0,4,10,23
Patrick Williams,7068360,AP,19,CHI,71,71,1983,255,528,0.483,54,138,0.391,201,390,0.515,0.534,91,125,0.728,66,261,327,99,64,46,98,126,655
Lauri Markkanen,6731508,AP,23,CHI,51,26,1317,250,521,0.48,119,296,0.402,131,225,0.582,0.594,76,92,0.826,35,233,268,45,26,15,52,75,695
Coby White,5572680,BA,20,CHI,69,54,2156,375,902,0.416,163,454,0.359,212,448,0.473,0.506,128,142,0.901,28,256,284,328,38,15,156,179,1041
Daniel Theis,5000000,P,28,TOT,65,51,1601,252,466,0.541,49,152,0.322,203,314,0.646,0.593,74,110,0.673,93,263,356,108,41,57,66,167,627
Garrett Temple,4767000,ES,34,CHI,56,25,1528,158,381,0.415,67,200,0.335,91,181,0.503,0.503,40,50,0.8,29,131,160,124,43,30,58,126,423
Denzel Valentine,4642800,ES,27,CHI,62,3,1036,155,416,0.373,80,242,0.331,75,174,0.431,0.469,16,17,0.941,24,173,197,105,30,7,42,70,406
Ryan Arcidiacono,3000000,BA,26,CHI,44,0,450,49,117,0.419,25,67,0.373,24,50,0.48,0.526,13,20,0.65,5,62,67,56,9,0,10,47,136
Javonte Green,1517981,ES,27,TOT,41,2,473,53,102,0.52,10,30,0.333,43,72,0.597,0.569,30,40,0.75,26,45,71,17,28,6,19,45,146
Pascal Siakam,30559200,AP,26,TOR,56,56,2006,437,961,0.455,73,246,0.297,364,715,0.509,0.493,249,301,0.827,95,310,405,250,64,37,130,174,1196
Kyle Lowry,30500000,BA,34,TOR,46,46,1601,260,596,0.436,131,331,0.396,129,265,0.487,0.546,140,160,0.875,35,212,247,338,45,14,126,143,791
Fred VanVleet,21250000,ES,26,TOR,52,52,1899,338,870,0.389,174,476,0.366,164,394,0.416,0.489,169,191,0.885,32,188,220,328,87,37,95,119,1019
Rodney Hood,10047450,AL,28,TOT,55,5,942,94,260,0.362,34,113,0.301,60,147,0.408,0.427,24,28,0.857,23,80,103,53,24,7,36,74,246
Aron Baynes,7000000,P,34,TOR,53,31,980,134,304,0.441,27,103,0.262,107,201,0.532,0.485,29,41,0.707,87,186,273,47,17,23,46,119,324
Chris Boucher,6500000,P,28,TOR,60,14,1453,288,560,0.514,90,235,0.383,198,325,0.609,0.595,152,193,0.788,117,287,404,63,35,111,46,166,818
OG Anunoby,3872215,AL,23,TOR,43,43,1433,249,519,0.48,104,261,0.398,145,258,0.562,0.58,80,102,0.784,54,183,237,94,66,32,75,114,682
Stanley Johnson,3804150,AP,24,TOR,61,13,1006,89,233,0.382,45,137,0.328,44,96,0.458,0.479,44,55,0.8,29,124,153,89,52,18,54,116,267
Malachi Flynn,1950600,BA,22,TOR,47,14,928,127,340,0.374,54,168,0.321,73,172,0.424,0.453,45,56,0.804,10,106,116,137,38,7,43,68,353
DeAndre' Bembry,1737145,AL,26,TOR,51,12,972,117,228,0.513,14,53,0.264,103,175,0.589,0.544,45,66,0.682,33,113,146,107,53,18,71,87,293
Paul Watson,1445697,AL,26,TOR,27,2,297,38,82,0.463,30,64,0.469,8,18,0.444,0.646,5,8,0.625,4,41,45,17,6,3,9,36,111
Yuta Watanabe,321893,AL,26,TOR,50,4,723,79,180,0.439,36,90,0.4,43,90,0.478,0.539,24,29,0.828,36,123,159,40,26,19,19,57,218
Henry Ellenson,160998,AP,24,TOR,2,0,38,5,14,0.357,2,9,0.222,3,5,0.6,0.429,3,4,0.75,3,9,12,5,0,0,0,7,15
Danilo Gallinari,19500000,AP,32,ATL,51,4,1222,206,475,0.434,103,254,0.406,103,221,0.466,0.542,161,174,0.925,17,194,211,76,30,10,43,105,676
Bogdan Bogdanović,18000000,ES,28,ATL,44,27,1305,267,565,0.473,146,333,0.438,121,232,0.522,0.602,40,44,0.909,20,140,160,147,49,13,54,99,720
Tony Snell,12178571,ES,29,ATL,47,23,992,88,171,0.515,62,109,0.569,26,62,0.419,0.696,11,11,1.0,18,94,112,59,13,11,21,75,249
Lou Williams,8000000,BA,34,TOT,66,4,1423,265,646,0.41,69,173,0.399,196,473,0.414,0.464,150,173,0.867,21,117,138,225,47,6,108,62,749
De'Andre Hunter,7422000,AL,23,ATL,23,19,678,120,248,0.484,31,95,0.326,89,153,0.582,0.546,73,85,0.859,17,93,110,44,19,12,29,59,344
Trae Young,6571800,BA,22,ATL,63,63,2125,487,1112,0.438,136,397,0.343,351,715,0.491,0.499,484,546,0.886,38,207,245,594,53,12,261,111,1594
Onyeka Okongwu,5813640,P,20,ATL,50,4,601,96,149,0.644,0,3,0.0,96,146,0.658,0.644,36,57,0.632,62,101,163,18,23,33,29,100,228
Kris Dunn,4767000,BA,26,ATL,4,0,45,1,12,0.083,0,2,0.0,1,10,0.1,0.083,3,4,0.75,0,6,6,2,2,2,3,10,5
Cam Reddish,4458000,AL,21,ATL,26,21,750,96,263,0.365,33,126,0.262,63,137,0.46,0.428,67,82,0.817,22,82,104,35,33,9,34,68,292
John Collins,4137302,AP,23,ATL,63,63,1848,429,771,0.556,83,208,0.399,346,563,0.615,0.61,170,204,0.833,118,349,467,78,34,63,84,193,1111
Kevin Huerter,2761920,ES,22,ATL,69,49,2126,316,731,0.432,140,386,0.363,176,345,0.51,0.528,50,64,0.781,38,193,231,241,82,18,79,165,822
Brandon Goodwin,1701593,BA,25,ATL,47,5,620,84,223,0.377,32,103,0.311,52,120,0.433,0.448,28,43,0.651,8,61,69,95,17,0,36,41,228
Solomon Hill,1620564,AP,29,ATL,71,16,1513,107,298,0.359,68,212,0.321,39,86,0.453,0.473,35,46,0.761,42,172,214,75,50,11,42,116,317
Bruno Fernando,1517981,P,22,ATL,33,0,226,18,44,0.409,0,2,0.0,18,42,0.429,0.409,15,22,0.682,16,62,78,10,4,3,21,23,51
Jimmy Butler,34379100,AL,31,MIA,52,52,1745,366,736,0.497,25,102,0.245,341,634,0.538,0.514,359,416,0.863,94,265,359,369,108,18,109,71,1116
Victor Oladipo,21000000,ES,28,TOT,33,33,1080,235,576,0.408,78,239,0.326,157,337,0.466,0.476,104,138,0.754,12,148,160,151,46,14,83,81,652
Goran Dragić,18000000,BA,34,MIA,50,11,1337,240,555,0.432,91,244,0.373,149,311,0.479,0.514,101,122,0.828,25,144,169,219,33,8,118,113,672
Andre Iguodala,15000000,AL,37,MIA,63,5,1339,95,248,0.383,60,182,0.33,35,66,0.53,0.504,25,38,0.658,38,183,221,142,57,35,67,90,275
Trevor Ariza,12800000,AL,35,MIA,30,27,841,99,241,0.411,50,143,0.35,49,98,0.5,0.515,34,44,0.773,27,117,144,55,31,18,21,55,282
Nemanja Bjelica,7150000,AP,32,TOT,37,3,595,89,196,0.454,27,85,0.318,62,111,0.559,0.523,37,51,0.725,29,98,127,69,15,5,33,68,242
Bam Adebayo,5115492,P,23,MIA,64,64,2143,456,800,0.57,2,8,0.25,454,792,0.573,0.571,283,354,0.799,142,431,573,346,75,66,169,145,1197
Tyler Herro,3822240,ES,21,MIA,54,15,1635,307,699,0.439,107,297,0.36,200,402,0.498,0.516,94,117,0.803,25,243,268,184,35,17,101,71,815
Precious Achiuwa,2582160,AP,21,MIA,61,4,737,124,228,0.544,0,1,0.0,124,227,0.546,0.544,56,110,0.509,73,135,208,29,20,28,43,91,304
Duncan Robinson,1663861,AL,26,MIA,72,72,2262,315,717,0.439,250,613,0.408,65,104,0.625,0.614,62,75,0.827,7,243,250,127,43,20,81,181,942
Kendrick Nunn,1663861,BA,25,MIA,56,44,1650,319,658,0.485,122,320,0.381,197,338,0.583,0.578,56,60,0.933,21,158,179,148,52,14,80,108,816
KZ Okpala,1517981,AP,21,MIA,37,9,447,36,96,0.375,12,50,0.24,24,46,0.522,0.438,8,15,0.533,21,47,68,19,10,11,15,59,92
James Harden,41254920,BA,31,TOT,44,43,1609,342,734,0.466,121,334,0.362,221,400,0.553,0.548,278,323,0.861,35,313,348,475,53,33,177,99,1083
Kevin Durant,39058950,AP,32,BRK,35,32,1157,324,603,0.537,85,189,0.45,239,414,0.577,0.608,210,238,0.882,13,234,247,195,25,45,120,70,943
Kyrie Irving,33460350,BA,28,BRK,54,54,1886,549,1086,0.506,152,378,0.402,397,708,0.561,0.576,201,218,0.922,52,205,257,324,76,37,130,140,1451
Joe Harris,16071429,AL,29,BRK,69,65,2141,357,707,0.505,211,444,0.475,146,263,0.555,0.654,49,63,0.778,43,205,248,130,46,14,62,141,974
Spencer Dinwiddie,11454048,ES,27,BRK,3,3,64,6,16,0.375,2,7,0.286,4,9,0.444,0.438,6,6,1.0,0,13,13,9,2,1,5,4,20
DeAndre Jordan,10375678,P,32,BRK,57,43,1246,190,249,0.763,0,1,0.0,190,248,0.766,0.763,46,92,0.5,117,310,427,93,17,65,85,116,426
Jeff Green,2564753,AP,34,BRK,68,38,1835,261,530,0.492,103,250,0.412,158,280,0.564,0.59,125,161,0.776,34,229,263,108,36,27,54,122,750
Landry Shamet,2090040,ES,23,BRK,61,12,1403,186,456,0.408,129,333,0.387,57,123,0.463,0.549,66,78,0.846,11,101,112,99,31,10,48,93,567
Timothé Luwawu-Cabarrot,1824003,AL,25,BRK,58,7,1050,130,356,0.365,75,239,0.314,55,117,0.47,0.471,35,43,0.814,28,101,129,69,33,6,43,99,370
Bruce Brown,1663861,BA,24,BRK,65,37,1451,235,423,0.556,17,59,0.288,218,364,0.599,0.576,86,117,0.735,111,238,349,104,58,28,54,145,573
Tyler Johnson,1620564,ES,28,BRK,39,3,684,72,183,0.393,48,132,0.364,24,51,0.471,0.525,18,21,0.857,6,71,77,47,14,0,17,43,210
Nic Claxton,1517981,P,21,BRK,32,1,594,90,145,0.621,1,5,0.2,89,140,0.636,0.624,31,64,0.484,43,123,166,28,23,40,18,68,212
Alize Johnson,621587,AP,24,BRK,18,0,189,40,68,0.588,1,6,0.167,39,62,0.629,0.596,13,13,1.0,27,63,90,14,5,5,9,16,94
Andre Roberson,274816,ES,29,BRK,5,0,63,2,14,0.143,1,8,0.125,1,6,0.167,0.179,1,2,0.5,7,8,15,4,3,1,2,4,6
Mike James,237648,BA,30,BRK,13,1,236,34,92,0.37,11,31,0.355,23,61,0.377,0.429,21,27,0.778,3,29,32,54,6,1,20,10,100
Kevin Love,31258256,AP,32,CLE,25,25,622,103,252,0.409,57,156,0.365,46,96,0.479,0.522,42,51,0.824,17,169,186,63,16,2,38,26,305
Taurean Prince,12250000,AP,26,TOT,41,10,905,131,327,0.401,62,155,0.4,69,172,0.401,0.495,65,76,0.855,19,123,142,76,28,23,47,75,389
Cedi Osman,8840580,AL,25,CLE,59,26,1510,219,586,0.374,99,324,0.306,120,262,0.458,0.458,76,95,0.8,38,163,201,174,53,9,80,119,613
Darius Garland,6720720,BA,21,CLE,54,50,1790,362,802,0.451,105,266,0.395,257,536,0.479,0.517,112,132,0.848,23,106,129,329,66,6,164,110,941
Isaac Okoro,6400920,ES,20,CLE,67,67,2173,235,559,0.42,62,214,0.29,173,345,0.501,0.476,114,157,0.726,68,138,206,128,62,24,86,185,646
Collin Sexton,4991880,ES,22,CLE,60,60,2115,525,1105,0.475,98,264,0.371,427,841,0.508,0.519,312,383,0.815,58,129,187,262,62,10,167,157,1460
Jarrett Allen,3909902,P,22,TOT,63,45,1864,298,482,0.618,6,19,0.316,292,463,0.631,0.624,204,290,0.703,196,435,631,106,32,90,100,96,806
Dylan Windler,2137440,AL,24,CLE,31,0,513,57,130,0.438,26,77,0.338,31,53,0.585,0.538,21,27,0.778,20,87,107,33,19,12,32,37,161
Damyean Dotson,2000000,ES,26,CLE,46,7,907,119,293,0.406,46,159,0.289,73,134,0.545,0.485,24,36,0.667,5,88,93,91,16,4,42,42,308
Matthew Dellavedova,1620564,BA,30,CLE,13,1,224,14,56,0.25,4,25,0.16,10,31,0.323,0.286,4,4,1.0,6,18,24,58,4,1,6,21,36
Isaiah Hartenstein,1620564,P,22,TOT,46,2,559,94,171,0.55,2,6,0.333,92,165,0.558,0.556,46,71,0.648,65,116,181,55,19,39,44,104,236
Dean Wade,1517981,AP,24,CLE,63,19,1212,134,311,0.431,78,213,0.366,56,98,0.571,0.556,30,39,0.769,38,177,215,74,35,21,30,78,376
Lamar Stevens,652366,AP,23,CLE,40,0,499,62,136,0.456,4,25,0.16,58,111,0.523,0.471,37,51,0.725,24,72,96,25,17,13,23,53,165
Rayjon Tucker,340000,BA,23,PHI,14,0,68,9,18,0.5,2,7,0.286,7,11,0.636,0.556,14,19,0.737,1,10,11,6,2,0,4,8,34
Thon Maker,309355,P,23,CLE,8,0,76,10,18,0.556,0,2,0.0,10,16,0.625,0.556,10,11,0.909,8,10,18,4,2,4,3,7,30
Khris Middleton,33051724,AL,29,MIL,68,68,2269,511,1074,0.476,151,365,0.414,360,709,0.508,0.546,212,236,0.898,54,352,406,370,74,9,178,160,1385
Giannis Antetokounmpo,27528088,AP,26,MIL,61,61,2013,626,1100,0.569,67,221,0.303,559,879,0.636,0.6,398,581,0.685,97,574,671,357,72,73,207,168,1717
Jrue Holiday,25876111,BA,30,MIL,59,56,1907,414,823,0.503,111,283,0.392,303,540,0.561,0.57,107,136,0.787,73,195,268,357,96,37,127,98,1046
Brook Lopez,12697675,P,32,MIL,70,70,1902,322,640,0.503,95,281,0.338,227,359,0.632,0.577,120,142,0.845,104,243,347,50,40,103,64,149,859
P.J. Tucker,7969537,AP,35,TOT,52,33,1356,66,177,0.373,40,119,0.336,26,58,0.448,0.486,21,28,0.75,51,153,204,61,39,20,40,125,193
Pat Connaughton,4938273,ES,28,MIL,69,4,1575,168,387,0.434,101,272,0.371,67,115,0.583,0.565,31,40,0.775,63,269,332,81,49,23,33,99,468
Bobby Portis,3623000,P,25,MIL,66,7,1372,313,598,0.523,74,157,0.471,239,441,0.542,0.585,54,73,0.74,124,342,466,71,52,26,56,115,754
Donte DiVincenzo,3044160,ES,24,MIL,66,66,1814,253,603,0.42,131,346,0.379,122,257,0.475,0.528,51,71,0.718,81,299,380,203,72,15,91,112,688
Bryn Forbes,2337145,ES,27,MIL,70,10,1354,250,529,0.473,154,341,0.452,96,188,0.511,0.618,47,61,0.77,11,101,112,45,24,1,44,77,701
Rodions Kurucs,1780152,AP,22,TOT,21,0,125,11,32,0.344,6,21,0.286,5,11,0.455,0.438,3,4,0.75,5,18,23,10,9,4,13,16,31
Thanasis Antetokounmpo,1701593,AL,28,MIL,57,3,551,67,137,0.489,7,29,0.241,60,108,0.556,0.515,25,49,0.51,54,70,124,46,22,10,43,74,166
Sam Merrill,898310,ES,24,MIL,30,2,233,32,72,0.444,21,47,0.447,11,25,0.44,0.59,4,4,1.0,6,24,30,21,8,1,10,17,89
Jordan Nwora,898310,AL,22,MIL,30,2,274,62,135,0.459,28,62,0.452,34,73,0.466,0.563,19,25,0.76,9,51,60,7,16,7,24,22,171
Mamadi Diakite,160173,AP,24,MIL,14,1,141,16,40,0.4,1,8,0.125,15,32,0.469,0.413,11,14,0.786,8,26,34,8,7,6,3,16,44
Elijah Bryant,24611,ES,25,MIL,1,0,32,6,13,0.462,1,5,0.2,5,8,0.625,0.5,3,3,1.0,2,4,6,3,0,1,4,4,16
Julius Randle,18900000,AP,26,NYK,71,71,2667,602,1321,0.456,160,389,0.411,442,932,0.474,0.516,348,429,0.811,84,639,723,427,64,18,241,225,1712
RJ Barrett,8231760,ES,20,NYK,72,72,2511,467,1060,0.441,124,309,0.401,343,751,0.457,0.499,206,276,0.746,68,346,414,217,53,20,139,188,1264
Derrick Rose,7682926,BA,32,TOT,50,3,1279,287,611,0.47,50,129,0.388,237,482,0.492,0.511,110,127,0.866,20,110,130,209,49,19,78,56,734
Frank Ntilikina,6176578,BA,22,NYK,33,4,322,29,79,0.367,23,48,0.479,6,31,0.194,0.513,8,18,0.444,6,25,31,19,18,4,11,45,89
Alec Burks,6000000,ES,29,NYK,49,5,1255,210,500,0.42,102,246,0.415,108,254,0.425,0.522,101,118,0.856,21,206,227,107,31,14,49,102,623
Elfrid Payton,5767000,BA,26,NYK,63,63,1484,269,622,0.432,28,98,0.286,241,524,0.46,0.455,73,107,0.682,64,152,216,203,47,9,103,116,639
Nerlens Noel,5000000,P,26,NYK,64,41,1547,137,223,0.614,0,3,0.0,137,220,0.623,0.614,50,70,0.714,142,266,408,46,70,141,65,176,324
Obi Toppin,4862040,AP,22,NYK,62,0,683,104,209,0.498,26,85,0.306,78,124,0.629,0.56,19,26,0.731,26,112,138,29,17,15,23,55,253
Kevin Knox,4588680,AL,21,NYK,42,0,464,56,143,0.392,35,89,0.393,21,54,0.389,0.514,16,20,0.8,10,51,61,19,12,6,17,37,163
Reggie Bullock,4200000,AL,29,NYK,65,64,1949,248,561,0.442,163,398,0.41,85,163,0.521,0.587,50,55,0.909,16,207,223,99,52,11,45,146,709
Vincent Poirier,2619207,P,27,PHI,10,0,39,3,12,0.25,0,1,0.0,3,11,0.273,0.25,2,6,0.333,6,8,14,2,0,3,4,8,8
Taj Gibson,2442968,P,35,NYK,45,3,936,99,158,0.627,3,15,0.2,96,143,0.671,0.636,40,55,0.727,99,151,250,36,31,49,22,99,241
Immanuel Quickley,2105520,BA,21,NYK,64,3,1243,229,580,0.395,118,303,0.389,111,277,0.401,0.497,155,174,0.891,25,112,137,127,30,12,58,114,731
Jared Harper,99020,BA,23,NYK,8,0,16,0,4,0.0,0,1,0.0,0,3,0.0,0.0,3,4,0.75,0,2,2,1,0,0,3,1,3
Tobias Harris,34358850,AP,28,PHI,62,62,2014,473,924,0.512,82,208,0.394,391,716,0.546,0.556,182,204,0.892,62,357,419,220,55,51,107,119,1210
Ben Simmons,30559200,BA,24,PHI,58,58,1877,325,583,0.557,3,10,0.3,322,573,0.562,0.56,176,287,0.613,93,324,417,401,93,35,173,171,829
Joel Embiid,29542010,P,26,PHI,51,51,1585,461,899,0.513,58,154,0.377,403,745,0.541,0.545,471,548,0.859,113,426,539,145,50,69,159,123,1451
Danny Green,15365853,AL,33,PHI,69,69,1934,224,544,0.412,175,432,0.405,49,112,0.438,0.573,31,40,0.775,55,205,260,118,92,56,67,125,654
George Hill,9590602,BA,34,TOT,30,17,672,95,197,0.482,31,80,0.388,64,117,0.547,0.561,40,50,0.8,16,45,61,73,23,5,31,31,261
Seth Curry,7834449,ES,30,PHI,57,57,1638,258,552,0.467,126,280,0.45,132,272,0.485,0.582,69,77,0.896,10,126,136,155,44,8,65,96,711
Mike Scott,5005350,AP,32,PHI,51,12,852,76,211,0.36,53,155,0.342,23,56,0.411,0.486,8,12,0.667,11,109,120,40,24,14,19,72,213
Matisse Thybulle,2711280,ES,23,PHI,65,8,1298,102,243,0.42,43,143,0.301,59,100,0.59,0.508,8,18,0.444,30,94,124,63,105,71,32,127,255
Tyrese Maxey,2478840,ES,20,PHI,61,8,935,198,429,0.462,31,103,0.301,167,326,0.512,0.498,61,70,0.871,11,93,104,120,26,13,41,79,488
Furkan Korkmaz,1762796,ES,23,PHI,55,11,1062,170,424,0.401,101,269,0.375,69,155,0.445,0.52,60,82,0.732,17,96,113,82,49,9,46,64,501
Shake Milton,1701593,ES,24,PHI,63,4,1461,300,667,0.45,71,203,0.35,229,464,0.494,0.503,146,176,0.83,33,115,148,193,39,18,103,130,817
Dwight Howard,1620564,P,35,PHI,69,6,1196,178,303,0.587,5,20,0.25,173,283,0.611,0.596,121,210,0.576,190,390,580,61,30,62,112,200,482
Isaiah Joe,898310,ES,21,PHI,41,1,383,48,133,0.361,39,106,0.368,9,27,0.333,0.508,18,24,0.75,6,30,36,20,12,4,11,34,153
Paul Reed,609128,AP,21,PHI,26,0,177,42,78,0.538,0,6,0.0,42,72,0.583,0.538,4,8,0.5,30,31,61,12,10,13,12,29,88
Anthony Tolliver,485498,AP,35,PHI,11,0,99,4,17,0.235,4,14,0.286,0,3,0.0,0.353,5,6,0.833,3,7,10,2,3,2,3,7,17
Kemba Walker,34379100,BA,30,BOS,43,43,1369,284,676,0.42,127,353,0.36,157,323,0.486,0.514,134,149,0.899,16,154,170,212,48,12,88,61,829
Jaylen Brown,23437500,ES,24,BOS,58,58,1999,538,1111,0.484,163,411,0.397,375,700,0.536,0.558,191,250,0.764,71,276,347,195,72,32,158,168,1430
Evan Fournier,17450000,AL,28,TOT,42,36,1259,247,541,0.457,117,283,0.413,130,258,0.504,0.565,108,137,0.788,10,118,128,144,47,19,73,96,719
Marcus Smart,13446428,BA,26,BOS,48,45,1581,203,510,0.398,93,282,0.33,110,228,0.482,0.489,128,162,0.79,36,131,167,273,72,23,96,126,627
Jayson Tatum,9897120,AL,22,BOS,64,64,2290,605,1318,0.459,187,485,0.386,418,833,0.502,0.53,295,340,0.868,50,422,472,276,75,31,171,122,1692
Tristan Thompson,9258000,P,29,BOS,54,43,1287,169,326,0.518,0,3,0.0,169,323,0.523,0.518,71,120,0.592,169,270,439,67,24,33,62,119,409
Romeo Langford,3631200,ES,21,BOS,18,4,283,21,59,0.356,5,18,0.278,16,41,0.39,0.398,9,12,0.75,12,23,35,13,6,5,10,24,56
Aaron Nesmith,3458400,AL,21,BOS,46,1,669,78,178,0.438,40,108,0.37,38,70,0.543,0.551,22,28,0.786,28,99,127,23,15,9,23,87,218
Grant Williams,2498760,AP,22,BOS,63,9,1138,108,247,0.437,48,129,0.372,60,118,0.508,0.534,30,51,0.588,48,130,178,64,32,24,56,161,294
Luke Kornet,2250000,P,25,TOT,31,2,348,44,101,0.436,15,59,0.254,29,42,0.69,0.51,3,6,0.5,14,53,67,24,4,32,7,20,106
Payton Pritchard,2035800,ES,23,BOS,66,4,1268,184,418,0.44,102,248,0.411,82,170,0.482,0.562,40,45,0.889,33,125,158,120,37,9,53,104,510
Robert Williams,2029920,P,23,BOS,52,13,985,186,258,0.721,0,2,0.0,186,256,0.727,0.721,45,73,0.616,133,225,358,94,43,91,52,105,417
Semi Ojeleye,1752950,AP,26,BOS,56,15,950,89,221,0.403,58,158,0.367,31,63,0.492,0.534,24,32,0.75,31,116,147,37,17,0,21,56,260
Carsen Edwards,1517981,ES,22,BOS,31,1,276,47,111,0.423,18,63,0.286,29,48,0.604,0.505,11,13,0.846,3,23,26,14,7,1,7,25,123
