Salario,Player,Pos,Age,G,GS,MP,FG,FGA,FG%,3P,3PA,3P%,2P,2PA,2P%,eFG%,FT,FTA,FT%,ORB,DRB,TRB,AST,STL,BLK,TOV,PF,PTS
16409091,Aaron gordon,AP,26,75,75,2376,434,834,0.52,87,260,0.335,347,574,0.605,0.573,171,230,0.743,125,314,439,188,44,44,133,148,1126
3980551,Aaron holiday,BA,25,63,15,1021,151,338,0.447,39,103,0.379,112,235,0.477,0.504,59,68,0.868,24,98,122,153,42,9,67,92,400
3631200,Aaron nesmith,AL,22,52,3,574,72,182,0.396,31,115,0.27,41,67,0.612,0.481,21,26,0.808,15,74,89,22,20,5,31,70,196
1000000,Aaron wiggins,ES,23,50,35,1209,156,337,0.463,42,138,0.304,114,199,0.573,0.525,62,85,0.729,51,127,178,68,30,10,54,93,416
2000000,Abdel nader,AL,28,14,0,145,12,35,0.343,4,14,0.286,8,21,0.381,0.4,6,10,0.6,4,23,27,7,8,4,11,20,34
300000,Admiral schofield,AL,24,38,1,469,54,129,0.419,26,79,0.329,28,50,0.56,0.519,12,15,0.8,17,72,89,25,4,5,21,58,146
27000000,Al horford,P,35,69,69,2005,266,569,0.467,89,265,0.336,177,304,0.582,0.546,80,95,0.842,108,422,530,232,49,92,65,130,701
9536000,Alec burks,ES,30,81,44,2318,285,728,0.391,157,389,0.404,128,339,0.378,0.499,217,264,0.822,47,350,397,239,85,26,91,215,944
3113160,Aleksej pokusevski,AP,20,61,12,1233,186,456,0.408,57,197,0.289,129,259,0.498,0.47,35,50,0.7,73,245,318,131,39,38,94,88,464
8600000,Alex caruso,ES,27,41,18,1147,102,256,0.398,42,126,0.333,60,130,0.462,0.48,58,73,0.795,33,115,148,165,71,15,57,106,304
3732000,Alex len,P,28,39,10,620,94,176,0.534,6,21,0.286,88,155,0.568,0.551,41,63,0.651,52,109,161,45,13,25,43,100,235
1254536,Alfonzo mckinnie,AL,29,17,3,206,24,61,0.393,9,27,0.333,15,34,0.441,0.467,2,8,0.25,13,20,33,5,2,3,7,26,59
1000000,Alize johnson,AP,25,23,0,167,17,39,0.436,0,4,0.0,17,35,0.486,0.436,7,12,0.583,28,33,61,9,5,0,12,18,41
3214680,Alperen şengün,P,19,72,13,1489,249,525,0.474,29,117,0.248,220,408,0.539,0.502,165,232,0.711,138,255,393,185,59,68,145,214,692
616117,Amir coffey,ES,24,69,30,1567,211,466,0.453,96,254,0.378,115,212,0.542,0.556,101,117,0.863,26,171,197,124,38,15,45,87,619
2401537,Andre drummond,P,28,73,36,1437,247,433,0.57,0,3,0.0,247,430,0.574,0.57,86,164,0.524,229,451,680,131,78,68,115,192,580
2641691,Andre iguodala,AL,38,31,0,603,46,121,0.38,17,74,0.23,29,47,0.617,0.45,15,20,0.75,21,79,100,114,27,22,28,34,124
31579390,Andrew wiggins,AL,26,73,73,2329,475,1019,0.466,157,399,0.393,318,620,0.513,0.543,149,235,0.634,85,240,325,161,76,51,111,158,1256
3938818,Anfernee simons,ES,22,57,30,1681,353,797,0.443,179,442,0.405,174,355,0.49,0.555,103,116,0.888,26,125,151,221,30,6,115,110,988
35361360,Anthony davis,P,28,40,40,1404,370,695,0.532,13,70,0.186,357,625,0.571,0.542,174,244,0.713,106,288,394,122,49,90,82,97,927
10245480,Anthony edwards,ES,20,72,72,2466,549,1245,0.441,215,602,0.357,334,643,0.519,0.527,220,280,0.786,62,281,343,275,105,46,190,164,1533
1517981,Anthony gil,AP,29,44,0,463,62,109,0.569,14,26,0.538,48,83,0.578,0.633,42,52,0.808,33,52,85,27,5,11,18,58,180
1800082,Armoni brooks,,23,54,11,844,98,289,0.339,74,249,0.297,24,40,0.6,0.467,18,21,0.857,20,83,103,62,28,11,27,74,288
925258,Austin reaves,ES,23,61,19,1418,146,318,0.459,53,167,0.317,93,151,0.616,0.542,99,118,0.839,45,148,193,110,29,20,40,87,444
2389641,Austin rivers,ES,29,67,18,1480,146,350,0.417,79,231,0.342,67,119,0.563,0.53,32,44,0.727,19,95,114,90,51,6,54,121,403
2641691,Avery bradley,ES,31,62,45,1406,148,350,0.423,82,210,0.39,66,140,0.471,0.54,16,18,0.889,31,105,136,47,53,9,38,118,394
925258,Ayo dosunmu,ES,22,77,40,2110,278,535,0.52,70,186,0.376,208,349,0.596,0.585,53,78,0.679,27,187,214,256,60,29,108,182,679
28103500,Bam adebayo,P,24,56,56,1825,406,729,0.557,0,6,0.0,406,723,0.562,0.557,256,340,0.753,137,427,564,190,80,44,148,171,1068
2389641,Ben mclemore,ES,28,64,6,1285,216,539,0.401,151,417,0.362,65,122,0.533,0.541,72,88,0.818,12,91,103,59,38,10,55,103,655
2641691,Blake griffin,AP,32,56,24,958,133,313,0.425,38,145,0.262,95,168,0.565,0.486,55,76,0.724,60,168,228,105,27,14,31,95,359
18700000,Bojan bogdanović,AP,32,69,69,2131,422,928,0.455,181,468,0.387,241,460,0.524,0.552,223,260,0.858,58,238,296,120,34,1,118,116,1248
2161152,Bol b,AP,22,14,0,81,15,27,0.556,1,4,0.25,14,23,0.609,0.574,2,5,0.4,4,16,20,5,1,2,4,4,33
2096880,Bones hyland,BA,21,69,4,1310,230,571,0.403,131,358,0.366,99,213,0.465,0.518,107,125,0.856,14,174,188,191,41,20,86,153,698
900000,Brad wanamaker,BA,32,23,2,320,28,77,0.364,4,17,0.235,24,60,0.4,0.39,23,25,0.92,6,33,39,55,7,6,23,45,83
33724200,Bradley beal,ES,28,40,40,1439,348,771,0.451,63,210,0.3,285,561,0.508,0.492,169,203,0.833,38,151,189,265,36,15,135,95,928
2726880,Brandon clarke,AP,25,64,1,1246,288,447,0.644,5,22,0.227,283,425,0.666,0.65,85,130,0.654,135,207,342,86,39,68,34,122,666
343988,Brandon goodwin,BA,26,36,5,502,64,154,0.416,19,55,0.345,45,99,0.455,0.477,24,38,0.632,14,53,67,91,25,1,36,39,171
29467800,Brandon ingram,AL,24,55,55,1869,453,983,0.461,74,226,0.327,379,757,0.501,0.498,266,322,0.826,35,285,320,307,34,26,151,119,1246
274672,Brandon knight,BA,30,5,0,65,10,25,0.4,4,17,0.235,6,8,0.75,0.48,8,8,1.0,0,8,8,8,1,0,4,5,32
125446,Braxton k,AL,24,11,0,197,33,72,0.458,6,21,0.286,27,51,0.529,0.5,7,13,0.538,13,37,50,11,10,11,11,26,79
13302325,Brook lopez,P,33,13,11,298,61,131,0.466,19,53,0.358,42,78,0.538,0.538,20,23,0.87,19,34,53,6,8,15,12,34,161
4736102,Bruce brown,AL,25,72,45,1774,256,506,0.506,38,94,0.404,218,412,0.529,0.543,97,128,0.758,100,245,345,148,77,52,56,176,647
1782621,Bruno fernando,P,23,30,0,152,36,55,0.655,1,2,0.5,35,53,0.66,0.664,15,24,0.625,18,37,55,7,1,11,14,24,88
4500000,Bryn forbes,ES,28,75,2,1286,231,539,0.429,122,295,0.414,109,244,0.447,0.542,79,87,0.908,10,83,93,75,25,5,56,95,663
23085960,Buddy hield,ES,29,81,32,2499,446,1098,0.406,262,716,0.366,184,382,0.482,0.526,111,127,0.874,66,287,353,229,73,25,153,184,1265
1517981,Cj elleby,AL,21,58,28,1174,121,308,0.393,37,126,0.294,84,182,0.462,0.453,60,84,0.714,66,161,227,87,35,19,56,116,339
30864198,Cj mccollum,ES,30,62,62,2145,536,1164,0.46,182,469,0.388,354,695,0.509,0.539,116,170,0.682,53,216,269,315,70,22,127,121,1370
10050120,Cade cunningham,BA,20,64,64,2088,429,1031,0.416,114,363,0.314,315,668,0.472,0.471,142,168,0.845,58,296,354,356,78,43,234,200,1114
84668,Caleb martin,AL,26,60,12,1372,208,410,0.507,64,155,0.413,144,255,0.565,0.585,71,93,0.763,70,160,230,64,58,30,52,104,551
4670160,Cam reddish,AL,22,49,7,1012,165,408,0.404,66,184,0.359,99,224,0.442,0.485,101,112,0.902,25,80,105,48,47,15,57,60,497
2036280,Cam thomas,ES,20,67,2,1176,218,503,0.433,47,174,0.27,171,329,0.52,0.48,87,105,0.829,16,145,161,78,33,8,55,66,570
4437000,Cameron johnson,AP,25,66,16,1730,279,607,0.46,166,391,0.425,113,216,0.523,0.596,98,114,0.86,42,231,273,99,57,16,47,113,822
53176,Cameron mcgriff,AL,24,3,0,46,5,14,0.357,2,6,0.333,3,8,0.375,0.429,2,2,1.0,6,9,15,3,0,1,0,7,14
85578,Cameron oliver,AL,25,2,0,43,10,15,0.667,1,3,0.333,9,12,0.75,0.7,2,3,0.667,2,4,6,3,1,1,0,5,23
6500000,Cameron payne,BA,27,58,12,1278,240,587,0.409,71,211,0.336,169,376,0.449,0.469,75,89,0.843,24,151,175,282,40,17,103,119,626
17500000,Caris levert,ES,27,58,49,1781,379,854,0.444,82,256,0.32,297,598,0.497,0.492,146,193,0.756,43,171,214,248,51,23,108,131,986
53176,Carlik jones,BA,24,5,0,23,1,9,0.111,0,1,0.0,1,8,0.125,0.111,2,2,1.0,1,2,3,5,1,0,3,0,4
2641691,Carmelo anthony,AP,37,69,3,1793,319,723,0.441,149,397,0.375,170,326,0.521,0.544,132,159,0.83,62,226,288,68,47,52,59,166,919
1800004,Carsen edwards,ES,23,4,0,79,9,30,0.3,4,16,0.25,5,14,0.357,0.367,1,1,1.0,2,4,6,14,2,0,5,4,23
256734,Cassius stanley,ES,22,9,1,155,19,46,0.413,4,17,0.235,15,29,0.517,0.457,10,10,1.0,5,14,19,4,5,2,6,17,52
8133334,Cedi osman,AL,26,66,3,1462,247,572,0.432,128,359,0.357,119,213,0.559,0.544,87,131,0.664,25,121,146,135,52,10,67,127,709
925258,Charles bassey,AP,21,23,0,168,30,47,0.638,0,4,0.0,30,43,0.698,0.638,9,12,0.75,22,40,62,7,5,17,8,32,69
1762796,Chimezie met,P,24,60,20,1279,203,449,0.452,57,186,0.306,146,263,0.555,0.516,71,91,0.78,34,301,335,60,51,32,61,93,534
7020000,Chris boucher,AP,29,80,9,1690,268,577,0.464,68,229,0.297,200,348,0.575,0.523,150,193,0.777,179,315,494,25,49,75,42,174,754
3749520,Chris duarte,ES,24,55,39,1541,268,621,0.432,94,255,0.369,174,366,0.475,0.507,90,112,0.804,41,185,226,114,56,10,90,95,720
30800000,Chris paul,BA,36,65,65,2139,363,736,0.493,63,199,0.317,300,537,0.559,0.536,169,202,0.837,22,261,283,702,121,20,153,134,958
13666667,Christian wood,P,26,68,67,2094,440,878,0.501,131,336,0.39,309,542,0.57,0.576,207,332,0.623,110,576,686,155,54,65,126,171,1218
3277080,Chuma okeke,AP,23,70,20,1749,216,575,0.376,118,371,0.318,98,204,0.48,0.478,55,65,0.846,47,300,347,118,97,42,57,95,605
18603448,Clint capela,P,27,74,73,2042,370,604,0.613,0,1,0.0,370,603,0.614,0.613,80,169,0.473,279,598,877,92,55,93,44,166,820
5837760,Coby white,BA,21,61,17,1675,279,644,0.433,136,353,0.385,143,291,0.491,0.539,78,91,0.857,17,165,182,176,29,11,70,137,772
1782621,Cody martin,AL,26,71,11,1866,204,423,0.482,61,159,0.384,143,264,0.542,0.554,75,107,0.701,82,203,285,179,88,32,61,116,544
2389641,Cody zeller,P,29,27,0,355,51,90,0.567,0,4,0.0,51,86,0.593,0.567,38,49,0.776,50,75,125,22,8,6,19,56,140
3449400,Cole anthony,BA,21,65,65,2059,357,912,0.391,132,391,0.338,225,521,0.432,0.464,216,253,0.854,32,316,348,369,46,17,170,171,1062
6349671,Collin sexton,ES,23,11,11,316,68,151,0.45,11,45,0.244,57,106,0.538,0.487,29,39,0.744,13,23,36,23,10,0,31,25,176
3383640,Corey kispert,AL,22,77,36,1801,234,514,0.455,112,320,0.35,122,194,0.629,0.564,54,62,0.871,53,156,209,85,35,22,50,93,634
7310000,Cory joseph,BA,30,65,39,1600,178,400,0.445,65,157,0.414,113,243,0.465,0.526,100,113,0.885,29,145,174,237,42,17,85,147,521
7000000,D.j. augustin,BA,34,55,2,883,94,222,0.423,68,164,0.415,26,58,0.448,0.577,38,43,0.884,11,57,68,107,17,1,56,39,294
308493,D.j. wilson,AP,25,4,1,54,11,15,0.733,0,2,0.0,11,13,0.846,0.733,8,10,0.8,1,15,16,5,5,1,2,6,30
611521,Daishen nix,ES,19,24,0,261,27,67,0.403,7,26,0.269,20,41,0.488,0.455,16,30,0.533,7,26,33,40,15,0,26,21,77
925258,Dalano banton,BA,22,64,1,696,83,202,0.411,13,51,0.255,70,151,0.464,0.443,26,44,0.591,38,86,124,99,28,10,53,68,205
1977011,Damian jones,P,26,56,15,1017,175,266,0.658,10,29,0.345,165,237,0.696,0.677,94,131,0.718,75,171,246,69,26,47,59,130,454
39344900,Damian lillard,BA,31,29,29,1056,222,552,0.402,92,284,0.324,130,268,0.485,0.486,159,181,0.878,13,107,120,212,17,11,83,37,695
1910860,Damion l,ES,29,63,5,1256,169,383,0.441,63,187,0.337,106,196,0.541,0.523,66,75,0.88,27,176,203,63,39,6,38,95,467
30013500,D'angelo russell,BA,25,65,65,2077,401,975,0.411,176,518,0.34,225,457,0.492,0.502,198,240,0.825,25,191,216,460,62,22,165,130,1176
1782621,Daniel gafford,P,23,72,53,1444,285,411,0.693,0,1,0.0,285,410,0.695,0.693,107,153,0.699,155,252,407,68,30,99,65,170,677
1585578,Daniel oturu,P,22,3,0,27,3,6,0.5,0,1,0.0,3,5,0.6,0.5,3,5,0.6,1,4,5,0,0,2,0,1,9
8280351,Daniel theis,P,29,47,27,977,151,291,0.519,33,107,0.308,118,184,0.641,0.576,49,72,0.681,59,169,228,41,20,31,46,111,384
20475000,Danilo gallinari,AP,33,66,18,1672,259,597,0.434,112,294,0.381,147,303,0.485,0.528,141,156,0.904,35,273,308,101,28,12,38,93,771
10000000,Danny green,AL,34,62,28,1353,126,320,0.394,103,271,0.38,23,49,0.469,0.555,11,14,0.786,32,125,157,64,60,37,45,105,366
4100000,Danuel house jr.,AL,28,42,7,727,80,198,0.404,44,117,0.376,36,81,0.444,0.515,44,58,0.759,18,93,111,44,21,17,33,51,248
2513040,Darius bazley,AP,21,69,53,1924,274,649,0.422,80,269,0.297,194,380,0.511,0.484,117,170,0.688,71,365,436,97,58,70,90,68,745
7040880,Darius garland,BA,22,68,68,2430,542,1173,0.462,174,454,0.383,368,719,0.512,0.536,215,241,0.892,39,185,224,583,89,7,248,115,1473
4650000,David nwaba,AL,29,46,4,609,85,176,0.483,15,49,0.306,70,127,0.551,0.526,48,67,0.716,41,110,151,35,28,20,21,55,233
4603320,Davion mitchell,BA,23,75,19,2076,352,843,0.418,101,320,0.316,251,523,0.48,0.477,56,85,0.659,33,133,166,313,55,24,114,141,861
16000000,Dāvis bertāns,AP,29,56,0,807,99,275,0.36,77,230,0.335,22,45,0.489,0.5,36,40,0.9,12,105,117,31,17,12,19,85,311
532398,Davon ree,ES,26,48,5,668,81,161,0.503,37,86,0.43,44,75,0.587,0.618,10,15,0.667,14,94,108,53,24,9,16,63,209
2009040,Day'ron sharpe,AP,20,32,8,391,86,149,0.577,2,7,0.286,84,142,0.592,0.584,24,41,0.585,81,79,160,17,10,15,30,60,198
28103500,De'aaron f,BA,24,59,59,2083,516,1092,0.473,74,249,0.297,442,843,0.524,0.506,261,348,0.75,25,206,231,330,68,25,168,172,1367
1782621,Dean wad,AP,25,51,28,980,99,217,0.456,51,142,0.359,48,75,0.64,0.574,20,30,0.667,31,119,150,52,29,7,16,88,269
12632950,Deandre ayton,P,23,58,58,1713,442,697,0.634,7,19,0.368,435,678,0.642,0.639,106,142,0.746,149,444,593,84,40,40,91,142,997
2500350,Deandre' bembry,AL,27,56,20,1026,124,221,0.561,15,36,0.417,109,185,0.589,0.595,21,35,0.6,42,121,163,66,49,25,31,113,284
7775400,De'andre hunter,AL,24,53,52,1577,254,575,0.442,74,195,0.379,180,380,0.474,0.506,127,166,0.765,26,150,176,68,36,21,69,155,709
8805976,De'anthony melton,ES,23,73,15,1657,281,695,0.404,139,372,0.374,142,323,0.44,0.504,90,120,0.75,64,264,328,194,104,39,112,128,791
15248880,Dejounte murray,BA,25,68,68,2366,573,1241,0.462,96,294,0.327,477,947,0.504,0.5,196,247,0.794,80,483,563,627,138,23,180,138,1438
8526316,Delon wright,ES,29,77,8,1452,122,269,0.454,44,116,0.379,78,153,0.51,0.535,54,63,0.857,50,170,220,188,93,19,45,56,342
26000000,Demar derozan,AP,32,76,76,2743,774,1535,0.504,50,142,0.352,724,1393,0.52,0.521,520,593,0.877,56,336,392,374,68,24,181,178,2118
1138659,Demarcus cousins,P,31,48,7,718,149,324,0.46,37,122,0.303,112,202,0.554,0.517,95,125,0.76,74,196,270,71,35,21,85,139,430
4692840,Deni avdija,AL,21,82,8,1984,250,579,0.432,82,259,0.317,168,320,0.525,0.503,103,136,0.757,52,373,425,167,59,44,87,190,685
5890000,Dennis schröder,,28,64,29,1837,312,724,0.431,86,250,0.344,226,474,0.477,0.49,157,184,0.853,34,180,214,296,53,8,143,154,867
1789256,Dennis smith jr.,BA,24,37,4,638,79,189,0.418,6,27,0.222,73,162,0.451,0.434,42,64,0.656,20,68,88,132,45,12,51,52,206
9720900,Derrick favors,P,30,39,18,653,94,182,0.516,2,16,0.125,92,166,0.554,0.522,16,25,0.64,58,126,184,25,17,12,9,62,206
9720900,Derrick jones jr.,AP,24,51,8,899,105,195,0.538,20,61,0.328,85,134,0.634,0.59,56,70,0.8,60,109,169,30,25,33,30,105,286
13445120,Derrick ros,BA,33,26,4,636,122,274,0.445,37,92,0.402,85,182,0.467,0.513,30,31,0.968,21,57,78,103,22,12,39,15,311
95930,Derrick walton,BA,26,3,3,108,6,26,0.231,3,13,0.231,3,13,0.231,0.288,4,4,1.0,2,8,10,21,7,4,11,8,19
15178571,Derrick white,ES,27,75,52,2199,337,800,0.421,115,369,0.312,222,431,0.515,0.493,203,235,0.864,38,223,261,366,64,58,119,172,992
2033160,Desmond bane,AL,23,76,76,2266,508,1101,0.461,228,523,0.436,280,578,0.484,0.565,140,155,0.903,46,288,334,208,92,29,111,196,1384
31650600,Devin booker,ES,25,68,68,2345,662,1421,0.466,183,478,0.383,479,943,0.508,0.53,315,363,0.868,45,297,342,329,77,26,162,180,1822
94136,Devin cannady,BA,25,5,0,145,15,44,0.341,15,37,0.405,0,7,0.0,0.511,5,7,0.714,1,5,6,10,5,3,5,9,50
4235160,Devin vassell,AL,21,71,32,1937,326,764,0.427,137,380,0.361,189,384,0.492,0.516,83,99,0.838,44,262,306,136,76,41,58,143,872
239291,Devon dotson,BA,22,11,0,85,11,23,0.478,2,9,0.222,9,14,0.643,0.522,5,9,0.556,1,8,9,15,1,0,5,11,29
11000000,Devonte' graham,BA,26,76,63,2162,296,815,0.363,192,563,0.341,104,252,0.413,0.481,118,140,0.843,37,140,177,316,71,12,105,95,902
2389641,Dewayne dedmon,P,32,67,15,1065,164,290,0.566,19,47,0.404,145,243,0.597,0.598,75,100,0.75,105,281,386,47,24,42,70,174,422
1768878,Didi louzada,,22,9,1,129,12,33,0.364,9,23,0.391,3,10,0.3,0.5,2,2,1.0,5,12,17,5,2,2,5,13,35
12200000,Dillon brooks,AL,26,32,31,885,227,526,0.432,46,149,0.309,181,377,0.48,0.475,90,106,0.849,29,73,102,88,36,8,50,105,590
19800000,Domantas sabonis,,25,62,61,2136,443,773,0.573,39,125,0.312,404,648,0.623,0.598,246,332,0.741,201,551,752,323,59,27,195,203,1171
28103500,Donovan mitchell,ES,25,67,67,2266,617,1376,0.448,232,654,0.355,385,722,0.533,0.533,267,313,0.853,55,227,282,358,99,12,200,164,1733
4675830,Donte divincenzo,ES,25,42,1,1006,118,336,0.351,74,218,0.339,44,118,0.373,0.461,70,83,0.843,40,130,170,118,48,8,72,69,380
4000000,Dorian finney-smith,AP,28,80,80,2644,326,692,0.471,172,435,0.395,154,257,0.599,0.595,56,83,0.675,122,253,375,150,88,39,80,183,880
13750000,Doug mcdermott,AP,30,51,51,1223,215,465,0.462,108,256,0.422,107,209,0.512,0.578,40,51,0.784,18,97,115,64,13,6,43,79,578
24026712,Draymond green,AP,31,46,44,1329,135,257,0.525,16,54,0.296,119,203,0.586,0.556,60,91,0.659,45,291,336,320,61,50,139,136,346
1796900,Drew eubanks,P,24,71,31,1245,221,371,0.596,5,23,0.217,216,348,0.621,0.602,99,130,0.762,130,252,382,85,31,40,81,122,546
462629,Duane washington jr.,BA,21,48,7,968,173,427,0.405,81,215,0.377,92,212,0.434,0.5,46,61,0.754,4,79,83,85,26,3,57,66,473
15650000,Duncan robinson,ES,27,79,68,2043,290,726,0.399,232,624,0.372,58,102,0.569,0.559,51,61,0.836,24,179,203,129,42,14,60,201,863
2641691,Dwight howard,P,36,60,27,971,134,219,0.612,8,15,0.533,126,204,0.618,0.63,96,146,0.658,118,238,356,35,34,36,47,115,372
11080125,Dwight powell,P,30,82,71,1798,269,401,0.671,13,37,0.351,256,364,0.703,0.687,166,212,0.783,173,231,404,97,37,39,64,220,717
2239200,Dylan windler,AL,25,50,0,459,37,98,0.378,21,70,0.3,16,28,0.571,0.485,15,18,0.833,21,68,89,34,14,3,16,47,110
2239544,Elfrid payton,BA,27,50,1,549,67,175,0.383,4,18,0.222,63,157,0.401,0.394,12,32,0.375,21,67,88,99,25,6,47,38,150
1517981,Elijah hughes,,23,36,4,434,47,144,0.326,25,95,0.263,22,49,0.449,0.413,7,9,0.778,6,52,58,22,14,8,17,39,126
2641691,Enes freedom,P,29,35,1,411,51,97,0.526,2,5,0.4,49,92,0.533,0.536,24,28,0.857,61,99,160,8,5,14,20,42,128
18125000,Eric bledsoe,BA,32,54,29,1361,197,468,0.421,51,163,0.313,146,305,0.479,0.475,89,117,0.761,28,154,182,225,69,19,116,85,534
18218818,Eric gordon,ES,33,57,46,1669,268,564,0.475,124,301,0.412,144,263,0.548,0.585,105,135,0.778,15,98,113,154,28,18,107,63,765
1782621,Eric paschall,AP,25,58,3,736,114,235,0.485,40,108,0.37,74,127,0.583,0.57,66,86,0.767,30,76,106,36,9,5,27,51,334
188774,Eugene omoruyi,AL,24,4,0,18,2,5,0.4,1,2,0.5,1,3,0.333,0.5,2,4,0.5,2,5,7,2,0,0,0,2,7
17142857,Evan fournier,ES,29,80,80,2358,402,965,0.417,241,619,0.389,161,346,0.465,0.541,80,113,0.708,34,176,210,171,79,20,105,180,1125
8075160,Evan mobley,AP,20,69,69,2331,422,830,0.508,23,92,0.25,399,738,0.541,0.522,167,252,0.663,143,427,570,174,56,115,133,147,1034
3200000,Facundo campazzo,BA,30,65,4,1184,107,296,0.361,58,193,0.301,49,103,0.476,0.459,60,78,0.769,23,94,117,220,63,23,67,124,332
3000000,Frank jackson,BA,23,53,7,1164,194,483,0.402,86,279,0.308,108,204,0.529,0.491,86,104,0.827,19,68,87,55,27,9,38,89,560
2089448,Frank kaminsky,P,28,9,0,181,36,66,0.545,5,15,0.333,31,51,0.608,0.583,18,20,0.9,11,30,41,13,8,7,5,14,95
1789256,Frank ntilikina,BA,23,58,5,685,89,223,0.399,38,111,0.342,51,112,0.455,0.484,24,25,0.96,12,67,79,69,27,7,31,61,240
5007840,Franz wagner,AL,20,79,79,2429,456,975,0.468,96,271,0.354,360,704,0.511,0.517,189,219,0.863,84,272,356,231,68,34,119,164,1197
19675926,Fred vanvleet,BA,27,65,65,2462,442,1097,0.403,242,642,0.377,200,455,0.44,0.513,194,222,0.874,44,245,289,434,111,35,170,162,1320
250000,Freddie gillespie,AP,24,9,2,119,9,22,0.409,0,1,0.0,9,21,0.429,0.409,3,7,0.429,13,23,36,5,3,9,5,18,21
4629630,Furkan korkmaz,ES,24,67,19,1414,182,470,0.387,77,266,0.289,105,204,0.515,0.469,68,84,0.81,22,153,175,127,33,9,48,58,509
1669178,Gabe vincent,BA,25,68,27,1589,214,513,0.417,119,323,0.368,95,190,0.5,0.533,44,54,0.815,22,104,126,210,62,12,98,158,591
4910000,Garrett temple,ES,35,59,16,1098,111,295,0.376,59,185,0.319,52,110,0.473,0.476,28,41,0.683,29,114,143,74,43,23,42,81,309
1255785,Garrison mathews,ES,25,65,33,1712,184,461,0.399,139,386,0.36,45,75,0.6,0.55,143,180,0.794,32,158,190,64,57,24,41,168,650
622253,Gary clark,AP,27,38,1,378,33,88,0.375,28,70,0.4,5,18,0.278,0.534,7,10,0.7,23,67,90,18,13,7,10,20,101
20482143,Gary harris,ES,27,61,30,1730,240,553,0.434,116,302,0.384,124,251,0.494,0.539,83,95,0.874,36,86,122,108,59,9,61,112,679
2598354,Gary payton ii,BA,29,71,16,1247,212,344,0.616,43,120,0.358,169,224,0.754,0.679,35,58,0.603,72,175,247,64,96,22,40,131,502
16000000,Gary trent jr.,ES,23,70,69,2448,450,1086,0.414,209,545,0.383,241,541,0.445,0.511,174,204,0.853,26,165,191,141,122,19,73,144,1283
4000000,George hil,ES,35,54,17,1253,118,275,0.429,41,134,0.306,77,141,0.546,0.504,57,62,0.919,38,117,155,120,42,6,41,70,334
85578,George kin,AL,28,4,0,19,0,5,0.0,0,4,0.0,0,1,0.0,0.0,1,2,0.5,0,5,5,0,0,0,1,4,1
3300000,Georges niang,AP,28,76,7,1736,246,563,0.437,156,387,0.403,90,176,0.511,0.575,52,59,0.881,25,178,203,102,30,13,59,190,700
553176,Georgios kalaitzakis,AL,23,13,4,214,31,67,0.463,10,26,0.385,21,41,0.512,0.537,14,30,0.467,6,15,21,12,11,2,20,19,86
39344900,Giannis antetokounmpo,AP,27,67,67,2204,689,1245,0.553,71,242,0.293,618,1003,0.616,0.582,553,766,0.722,134,644,778,388,72,91,219,212,2002
3098400,Goga bitadze,P,22,50,16,729,131,252,0.52,23,80,0.288,108,172,0.628,0.565,64,94,0.681,79,98,177,55,21,42,46,107,349
18000000,Goran dragić,BA,35,21,8,498,57,151,0.377,16,63,0.254,41,88,0.466,0.43,27,33,0.818,13,52,65,86,19,4,34,45,157
29925000,Gordon hayward,AL,31,49,48,1564,283,617,0.459,86,220,0.391,197,397,0.496,0.528,126,149,0.846,38,186,224,177,47,22,81,85,778
4000000,Gorgui dieng,P,32,44,3,371,53,112,0.473,29,68,0.426,24,44,0.545,0.603,19,26,0.731,32,89,121,34,11,13,20,52,154
2617800,Grant williams,AP,23,77,21,1875,205,432,0.475,106,258,0.411,99,174,0.569,0.597,86,95,0.905,64,210,274,78,38,57,62,186,602
4054695,Grayson allen,ES,26,66,61,1805,255,569,0.448,159,389,0.409,96,180,0.533,0.588,64,74,0.865,32,190,222,100,46,18,43,96,733
925258,Greg brown iii,AL,20,48,6,640,81,190,0.426,19,61,0.311,62,129,0.481,0.476,44,65,0.677,38,97,135,35,26,24,36,90,225
5200000,Hamidou diallo,ES,23,58,29,1269,261,526,0.496,23,93,0.247,238,433,0.55,0.518,91,140,0.65,69,208,277,73,71,17,58,143,636
20284091,Harrison barnes,AP,29,77,77,2587,391,834,0.469,142,360,0.394,249,474,0.525,0.554,341,413,0.826,82,350,432,186,53,14,118,94,1265
106352,Hassani gravett,BA,25,8,3,171,18,38,0.474,11,26,0.423,7,12,0.583,0.618,3,4,0.75,1,20,21,20,5,1,9,13,50
547341,Haywood highsmith,AL,25,19,1,163,16,46,0.348,9,28,0.321,7,18,0.389,0.446,2,5,0.4,10,16,26,6,2,3,3,13,43
1700000,Herbert jones,AP,23,78,69,2335,274,576,0.476,57,169,0.337,217,407,0.533,0.525,137,163,0.84,98,198,296,167,130,60,100,238,742
2210640,Immanuel quickley,BA,22,78,3,1802,284,724,0.392,137,396,0.346,147,328,0.448,0.487,177,201,0.881,31,216,247,275,54,3,99,167,882
1729217,Isaac bonga,AL,22,15,0,69,3,13,0.231,1,4,0.25,2,9,0.222,0.269,5,8,0.625,4,3,7,4,8,2,2,10,12
6720720,Isaac okoro,AL,21,67,61,1981,207,431,0.48,55,157,0.35,152,274,0.555,0.544,119,155,0.768,72,129,201,121,56,22,58,164,588
1729217,Isaiah hartenstein,P,23,68,0,1216,229,366,0.626,14,30,0.467,215,336,0.64,0.645,91,132,0.689,117,215,332,160,50,77,84,167,563
2451120,Isaiah j,ES,22,55,1,609,62,177,0.35,45,135,0.333,17,42,0.405,0.477,29,31,0.935,6,50,56,35,14,3,19,47,198
1517981,Isaiah jackson,AP,20,36,15,541,116,206,0.563,5,16,0.313,111,190,0.584,0.575,60,88,0.682,60,89,149,10,25,52,40,92,297
1057260,Isaiah livers,AL,23,19,5,383,41,90,0.456,27,64,0.422,14,26,0.538,0.606,12,14,0.857,15,42,57,21,13,7,15,37,121
1782621,Isaiah rob,AP,23,45,28,948,166,323,0.514,44,99,0.444,122,224,0.545,0.582,78,116,0.672,75,142,217,71,36,34,43,109,454
3277080,Isaiah stewart,P,20,71,71,1816,250,490,0.51,15,46,0.326,235,444,0.529,0.526,74,103,0.718,226,391,617,82,22,78,85,211,589
607285,Isaiah thomas,BA,32,22,1,333,67,167,0.401,28,83,0.337,39,84,0.464,0.485,22,26,0.846,4,25,29,34,7,5,15,34,184
1500000,Isaiah tod,AP,20,12,0,74,7,26,0.269,4,16,0.25,3,10,0.3,0.346,2,6,0.333,3,9,12,4,4,2,4,4,20
4500000,Ish smith,BA,33,65,1,1126,185,430,0.43,25,67,0.373,160,363,0.441,0.459,15,24,0.625,25,115,140,244,47,23,78,78,410
467947,Ish wainright,AP,27,45,0,359,41,104,0.394,19,59,0.322,22,45,0.489,0.486,7,12,0.583,27,27,54,15,20,6,13,49,108
9603360,Ja morant,BA,22,57,57,1889,580,1177,0.493,88,256,0.344,492,921,0.534,0.53,316,415,0.761,77,248,325,384,66,22,196,86,1564
1068288,Jabari parker,AP,26,12,0,112,18,38,0.474,8,16,0.5,10,22,0.455,0.579,9,9,1.0,5,23,28,6,4,1,8,13,53
2063280,Jaden mcdaniels,AP,21,70,31,1803,255,554,0.46,80,252,0.317,175,302,0.579,0.532,57,71,0.803,76,217,293,79,52,54,75,224,647
9720900,Jae crowder,AP,31,67,67,1886,217,544,0.399,127,365,0.348,90,179,0.503,0.516,71,90,0.789,30,324,354,124,95,30,55,173,632
1517981,Jae'sean tat,AL,26,78,77,2056,363,729,0.498,63,202,0.312,300,527,0.569,0.541,130,184,0.707,135,285,420,222,72,41,139,286,919
1517981,Jahmi'us ramsey,ES,20,19,0,134,24,58,0.414,5,18,0.278,19,40,0.475,0.457,7,14,0.5,4,9,13,7,1,1,5,10,60
3940184,Jake layman,AL,27,34,1,231,30,73,0.411,8,35,0.229,22,38,0.579,0.466,13,18,0.722,6,30,36,9,7,5,10,12,81
8750000,Jakob poeltl,P,26,68,67,1970,410,663,0.618,1,1,1.0,409,662,0.618,0.619,94,190,0.495,262,372,634,189,45,118,109,212,915
1802057,Jalen brunson,BA,25,79,61,2524,506,1008,0.502,94,252,0.373,412,756,0.545,0.549,179,213,0.84,43,266,309,377,66,3,124,151,1285
8992200,Jalen green,ES,19,67,67,2138,406,954,0.426,157,458,0.343,249,496,0.502,0.508,188,236,0.797,33,193,226,176,44,18,135,103,1157
2659560,Jalen johnson,AP,20,22,0,120,22,41,0.537,3,13,0.231,19,28,0.679,0.573,5,7,0.714,2,24,26,3,3,2,9,9,52
1782621,Jalen mcdaniels,AL,24,55,2,895,123,254,0.484,41,108,0.38,82,146,0.562,0.565,53,72,0.736,37,133,170,58,26,22,36,93,340
4458000,Jalen smith,AP,21,51,8,925,176,350,0.503,40,122,0.328,136,228,0.596,0.56,78,102,0.765,101,206,307,24,15,41,42,96,470
6593040,Jalen suggs,BA,20,48,45,1307,198,548,0.361,42,196,0.214,156,352,0.443,0.4,126,163,0.773,26,145,171,209,59,19,143,142,564
4154400,James bouknight,ES,21,31,0,304,49,141,0.348,17,49,0.347,32,92,0.348,0.408,27,31,0.871,22,30,52,26,7,1,15,29,142
128709,James ennis iii,AL,31,7,0,56,11,24,0.458,3,8,0.375,8,16,0.5,0.521,4,5,0.8,5,7,12,3,2,2,2,5,29
44310840,James harden,,32,65,65,2419,407,992,0.41,148,448,0.33,259,544,0.476,0.485,470,536,0.877,55,445,500,667,82,36,284,153,1432
2641691,James johnson,AP,34,62,10,1191,144,307,0.469,23,85,0.271,121,222,0.545,0.507,29,55,0.527,51,164,215,130,30,34,48,162,340
8292683,Jamychal green,AP,31,67,8,1085,159,327,0.486,33,124,0.266,126,203,0.621,0.537,81,93,0.871,81,200,281,59,43,26,57,158,432
925258,Jared butler,ES,21,42,1,360,61,151,0.404,28,88,0.318,33,63,0.524,0.497,11,16,0.688,5,40,45,63,17,8,33,47,161
9180560,Jaren jackson jr.,AP,22,78,78,2126,430,1036,0.415,128,401,0.319,302,635,0.476,0.477,284,345,0.823,119,335,454,86,73,177,130,272,1272
4050000,Jarred vanderbilt,AP,22,74,67,1880,212,361,0.587,2,14,0.143,210,347,0.605,0.59,86,131,0.656,215,409,624,94,99,46,73,181,512
20000000,Jarrett allen,P,23,56,56,1809,369,545,0.677,1,10,0.1,368,535,0.688,0.678,165,233,0.708,192,410,602,92,44,75,94,97,904
6395160,Jarrett culver,ES,22,37,0,338,51,135,0.378,12,47,0.255,39,88,0.443,0.422,16,34,0.471,13,35,48,33,20,5,20,42,130
5000000,Javale mcgee,P,34,74,17,1172,288,458,0.629,2,9,0.222,286,449,0.637,0.631,102,146,0.699,163,333,496,42,22,81,98,181,680
1669178,Javonte green,AL,28,65,45,1519,176,325,0.542,36,101,0.356,140,224,0.625,0.597,80,96,0.833,91,185,276,60,67,32,30,132,468
5348280,Jaxson hayes,P,21,70,28,1398,245,398,0.616,20,57,0.351,225,341,0.66,0.641,144,188,0.766,115,200,315,43,33,55,54,155,654
26758928,Jaylen brown,AL,25,66,66,2220,576,1217,0.473,166,464,0.358,410,753,0.544,0.541,241,318,0.758,53,351,404,231,70,18,178,163,1559
191860,Jaylen hoard,AL,22,7,5,240,44,90,0.489,9,25,0.36,35,65,0.538,0.539,6,14,0.429,30,54,84,17,6,5,8,14,103
95930,Jaylen morris,ES,26,3,0,16,0,6,0.0,0,2,0.0,0,4,0.0,0.0,2,4,0.5,0,2,2,2,0,0,1,2,2
1782621,Jaylen nowell,ES,22,62,1,975,196,413,0.475,63,160,0.394,133,253,0.526,0.551,72,92,0.783,22,101,123,130,27,10,36,73,527
28103500,Jayson tatum,AL,23,76,76,2731,708,1564,0.453,230,651,0.353,478,913,0.524,0.526,400,469,0.853,85,524,609,334,75,49,217,174,2046
253176,Jeff dowtin,BA,24,9,0,108,8,26,0.308,1,9,0.111,7,17,0.412,0.327,2,2,1.0,8,10,18,10,5,1,5,5,19
4500000,Jeff green,P,35,75,63,1849,277,529,0.524,53,168,0.315,224,361,0.62,0.574,165,198,0.833,41,190,231,96,28,27,71,151,772
20002500,Jerami grant,AP,27,47,47,1500,298,699,0.426,91,254,0.358,207,445,0.465,0.491,217,259,0.838,28,163,191,111,44,49,85,107,904
2000000,Jeremiah robinson-earl,P,21,49,36,1087,134,324,0.414,58,165,0.352,76,159,0.478,0.503,40,54,0.741,75,199,274,49,29,15,39,75,366
10500000,Jeremy lamb,,29,56,0,935,133,347,0.383,55,170,0.324,78,177,0.441,0.463,89,106,0.84,26,128,154,81,31,22,37,59,410
457149,Jevon carter,BA,26,66,3,905,98,253,0.387,66,170,0.388,32,83,0.386,0.518,15,18,0.833,14,96,110,96,24,14,34,67,277
36016200,Jimmy butler,AL,32,57,57,1931,398,829,0.48,27,116,0.233,371,713,0.52,0.496,396,455,0.87,102,234,336,312,94,27,121,88,1219
925258,Jock landale,P,26,54,1,589,101,204,0.495,29,89,0.326,72,115,0.626,0.566,34,41,0.829,63,75,138,45,10,14,31,53,265
17357143,Joe harris,AL,30,14,14,423,56,124,0.452,41,88,0.466,15,36,0.417,0.617,5,6,0.833,5,51,56,14,7,2,16,31,158
13036364,Joe ingles,AL,34,45,15,1122,115,285,0.404,78,225,0.347,37,60,0.617,0.54,17,22,0.773,12,119,131,158,23,5,46,82,325
566322,Joe wieskamp,ES,22,29,0,205,20,56,0.357,14,43,0.326,6,13,0.462,0.482,7,13,0.538,4,10,14,9,4,3,2,14,61
31579390,Joel embiid,P,27,68,68,2297,666,1334,0.499,93,251,0.371,573,1083,0.529,0.534,654,803,0.814,146,650,796,284,77,99,214,181,2079
23000000,John collins,AP,24,54,53,1663,339,644,0.526,64,176,0.364,275,468,0.588,0.576,134,169,0.793,93,329,422,98,33,56,60,164,876
2200000,John konchar,ES,25,72,7,1292,135,262,0.515,52,126,0.413,83,136,0.61,0.615,27,49,0.551,87,242,329,109,45,22,29,90,349
14000000,Jonas valančiūnas,P,29,74,74,2240,510,938,0.544,57,158,0.361,453,780,0.581,0.574,237,289,0.82,226,617,843,190,41,60,179,247,1314
5466360,Jonathan kuminga,AL,19,70,12,1185,236,460,0.513,50,149,0.336,186,311,0.598,0.567,130,190,0.684,54,180,234,64,31,22,74,146,652
12420000,Jordan clarkson,ES,29,79,1,2141,466,1113,0.419,190,597,0.318,276,516,0.535,0.504,144,174,0.828,67,206,273,194,66,16,129,149,1266
2000000,Jordan mclaughlin,BA,25,62,3,902,88,200,0.44,27,85,0.318,61,115,0.53,0.508,30,40,0.75,22,72,94,180,57,10,38,54,233
1517981,Jordan nwora,AL,23,62,13,1185,186,462,0.403,79,227,0.348,107,235,0.455,0.488,36,43,0.837,37,184,221,59,25,17,57,78,487
2161440,Jordan poole,ES,22,76,51,2283,474,1058,0.448,211,580,0.364,263,478,0.55,0.548,246,266,0.925,34,226,260,304,60,23,187,206,1405
1500000,Jose alvarado,BA,23,54,1,834,131,294,0.446,32,110,0.291,99,184,0.538,0.5,36,53,0.679,25,75,100,152,71,7,40,73,330
2259240,Josh christopher,ES,20,74,2,1334,224,500,0.448,56,189,0.296,168,311,0.54,0.504,83,113,0.735,52,134,186,150,65,13,114,97,587
5988000,Josh giddey,ES,19,54,54,1700,281,670,0.419,56,213,0.263,225,457,0.492,0.461,56,79,0.709,98,323,421,345,51,20,171,88,674
2957520,Josh green,ES,21,67,3,1039,130,256,0.508,28,78,0.359,102,178,0.573,0.563,31,45,0.689,52,109,161,79,45,14,44,115,319
12000000,Josh har,,26,54,53,1791,287,569,0.504,73,213,0.343,214,356,0.601,0.569,160,211,0.758,62,326,388,224,61,13,114,150,807
5005350,Josh jackson,AL,24,51,3,830,120,300,0.4,33,130,0.254,87,170,0.512,0.455,55,77,0.714,21,120,141,54,26,22,47,88,328
4087904,Josh okogie,ES,23,49,6,516,42,104,0.404,14,47,0.298,28,57,0.491,0.471,35,51,0.686,29,41,70,25,26,12,23,53,133
3946800,Joshua primo,ES,19,50,16,965,101,270,0.374,42,137,0.307,59,133,0.444,0.452,44,59,0.746,32,81,113,81,20,23,57,79,288
11615328,Josh richardson,ES,28,65,7,1600,234,534,0.438,102,246,0.415,132,288,0.458,0.534,96,108,0.889,42,143,185,115,56,29,66,116,666
32431333,Jrue holiday,BA,31,67,64,2207,478,954,0.501,132,321,0.411,346,633,0.547,0.57,137,180,0.761,69,232,301,457,108,29,183,133,1225
1701593,Juan toscano-anderson,AL,28,73,6,994,115,235,0.489,28,87,0.322,87,148,0.588,0.549,40,70,0.571,28,148,176,127,48,17,68,115,298
7012440,Juancho hernangómez,AP,26,40,9,445,44,106,0.415,24,69,0.348,20,37,0.541,0.528,19,34,0.559,28,72,100,20,14,10,16,25,131
21780000,Julius randle,AP,27,72,72,2544,512,1246,0.411,120,390,0.308,392,856,0.458,0.459,303,401,0.756,125,591,716,370,53,39,245,205,1447
111457,Justin anderson,AL,28,16,6,316,36,95,0.379,15,59,0.254,21,36,0.583,0.458,15,19,0.789,4,42,46,33,8,6,8,22,102
6006420,Justin holiday,,32,74,65,2057,261,662,0.394,177,482,0.367,84,180,0.467,0.528,50,62,0.806,29,161,190,128,57,33,70,154,749
205662,Justin jackson,AL,26,7,0,37,5,15,0.333,3,9,0.333,2,6,0.333,0.433,2,2,1.0,1,6,7,2,0,0,1,3,15
119645,Justin robinson,BA,24,25,0,304,28,93,0.301,18,61,0.295,10,32,0.313,0.398,4,8,0.5,4,17,21,32,9,1,17,27,78
3902439,Justise winslow,AL,25,48,11,774,110,257,0.428,15,66,0.227,95,191,0.497,0.457,39,66,0.591,50,152,202,84,35,25,49,67,274
12000000,Jusuf nurkić,P,27,56,56,1579,321,600,0.535,15,56,0.268,306,544,0.563,0.548,185,268,0.69,167,452,619,157,62,34,143,189,842
13038862,Kentavious caldwell-pope,ES,28,77,77,2329,361,829,0.435,159,408,0.39,202,421,0.48,0.531,137,154,0.89,41,220,261,145,83,26,97,139,1018
1517981,Kenyon martin jr.,AL,21,79,2,1656,279,523,0.533,60,168,0.357,219,355,0.617,0.591,78,123,0.634,80,217,297,101,34,40,60,113,696
2770560,Kai jones,P,21,21,0,63,9,14,0.643,1,2,0.5,8,12,0.667,0.679,3,8,0.375,3,8,11,4,1,2,6,8,22
31650600,Karl-anthony towns,P,26,74,74,2476,642,1214,0.529,150,366,0.41,492,848,0.58,0.591,384,467,0.822,194,533,727,269,72,83,226,267,1818
558345,Keifer sykes,BA,28,32,11,566,69,190,0.363,27,90,0.3,42,100,0.42,0.434,15,17,0.882,8,37,45,62,12,4,33,51,180
1729217,Keita bates-diop,AL,26,59,14,956,136,263,0.517,17,55,0.309,119,208,0.572,0.549,46,61,0.754,62,169,231,41,27,14,45,61,335
191860,Kelan martin,AL,26,30,1,450,70,171,0.409,22,75,0.293,48,96,0.5,0.474,9,13,0.692,17,38,55,21,13,9,14,36,171
2145720,Keldon johnson,AL,22,75,74,2392,471,1011,0.466,159,399,0.398,312,612,0.51,0.545,177,234,0.756,80,377,457,158,58,14,92,148,1278
12195122,Kelly olynyk,P,30,40,1,764,128,286,0.448,40,119,0.336,88,167,0.527,0.517,69,89,0.775,54,123,177,111,31,19,58,100,365
12000000,Kelly oubre jr.,AL,26,76,13,1999,410,932,0.44,191,553,0.345,219,379,0.578,0.542,126,189,0.667,79,223,302,84,77,31,67,189,1137
8729020,Kemba walker,BA,31,37,37,948,149,370,0.403,73,199,0.367,76,171,0.444,0.501,60,71,0.845,14,97,111,131,26,7,48,37,431
2000000,Kenrich williams,AL,27,49,0,1072,146,317,0.461,41,121,0.339,105,196,0.536,0.525,30,55,0.545,75,145,220,108,44,10,46,81,363
2401537,Kent bazemore,AL,32,39,14,545,45,139,0.324,29,80,0.363,16,59,0.271,0.428,13,17,0.765,13,56,69,34,25,9,21,70,132
2553120,Keon johnson,ES,19,37,12,697,96,272,0.353,34,100,0.34,62,172,0.36,0.415,41,51,0.804,24,57,81,76,28,12,46,69,267
467947,Kessler edwards,AL,21,48,23,987,110,267,0.412,48,136,0.353,62,131,0.473,0.502,16,19,0.842,44,128,172,31,29,24,42,85,284
42018900,Kevin durant,AP,33,55,55,2047,578,1115,0.518,115,300,0.383,463,815,0.568,0.57,372,409,0.91,29,378,407,351,48,52,191,113,1643
4253357,Kevin huerter,ES,23,74,60,2188,345,760,0.454,160,411,0.389,185,349,0.53,0.559,42,52,0.808,32,222,254,203,55,26,91,185,892
5845978,Kevin knox,AL,22,30,0,222,31,85,0.365,15,54,0.278,16,31,0.516,0.453,16,22,0.727,14,30,44,10,4,2,7,19,93
31258256,Kevin love,AP,33,74,4,1665,327,761,0.43,187,477,0.392,140,284,0.493,0.553,166,198,0.838,87,449,536,160,26,18,98,101,1007
1669178,Kevin pangos,BA,29,24,3,166,15,46,0.326,6,26,0.231,9,20,0.45,0.391,3,4,0.75,2,9,11,30,3,0,7,11,39
1782621,Kevin porter jr.,BA,21,61,61,1907,335,808,0.415,155,413,0.375,180,395,0.456,0.511,124,193,0.642,43,224,267,376,69,22,192,156,949
5178572,Kevon looney,P,25,82,80,1732,208,364,0.571,0,1,0.0,208,363,0.573,0.571,75,125,0.6,208,388,596,165,50,52,67,215,491
6350000,Khem birch,P,29,55,28,991,97,200,0.485,0,14,0.0,97,186,0.522,0.485,53,71,0.746,122,117,239,56,30,26,29,104,247
35500000,Khris middleton,AL,30,66,66,2141,452,1021,0.443,162,434,0.373,290,587,0.494,0.522,259,291,0.89,41,315,356,358,76,18,190,160,1325
5572680,Killian hayes,BA,20,66,40,1647,176,459,0.383,44,167,0.263,132,292,0.452,0.431,57,74,0.77,36,174,210,277,78,35,111,183,453
2000000,Killian tillie,P,23,36,3,461,43,127,0.339,27,86,0.314,16,41,0.39,0.445,5,8,0.625,21,39,60,22,23,15,13,58,118
3822240,Kira lewis jr.,BA,20,24,0,341,59,146,0.404,13,58,0.224,46,88,0.523,0.449,10,12,0.833,9,30,39,49,11,1,26,17,141
37980720,Klay thompson,ES,31,32,32,941,246,573,0.429,114,296,0.385,132,277,0.477,0.529,46,51,0.902,15,110,125,88,16,17,43,54,652
334371,Kris dun,BA,27,14,3,336,44,102,0.431,1,11,0.091,43,91,0.473,0.436,17,18,0.944,9,40,49,79,23,3,32,38,106
31650600,Kristaps porziņģis,AP,26,51,51,1481,352,767,0.459,78,252,0.31,274,515,0.532,0.51,248,286,0.867,102,309,411,119,37,84,81,137,1030
9937150,Kyle anderson,AP,28,69,11,1484,209,469,0.446,36,109,0.33,173,360,0.481,0.484,67,105,0.638,69,299,368,183,77,45,71,108,521
369999,Kyle g,ES,24,19,0,186,26,65,0.4,14,40,0.35,12,25,0.48,0.508,8,12,0.667,4,13,17,17,7,1,13,12,74
13000000,Kyle kuzma,AP,26,66,66,2204,423,936,0.452,128,375,0.341,295,561,0.526,0.52,156,219,0.712,70,491,561,233,42,57,169,128,1130
26984128,Kyle lowry,BA,35,63,63,2133,276,627,0.44,144,382,0.377,132,245,0.539,0.555,148,174,0.851,33,249,282,474,67,17,168,177,844
35328700,Kyrie irving,BA,29,29,29,1091,289,616,0.469,100,239,0.418,189,377,0.501,0.55,118,129,0.915,16,111,127,167,41,17,73,81,796
1782621,Kz okpala,AP,22,21,0,244,30,69,0.435,9,26,0.346,21,43,0.488,0.5,8,11,0.727,11,30,41,14,4,7,5,25,77
1517981,Lamar stevens,AP,24,63,13,1015,156,319,0.489,18,65,0.277,138,254,0.543,0.517,53,75,0.707,47,117,164,44,31,18,41,106,383
2641691,Lamarcus aldridge,P,36,47,12,1050,252,458,0.55,14,46,0.304,238,412,0.578,0.566,89,102,0.873,73,185,258,42,14,47,44,78,607
8231760,Lamelo bal,BA,20,75,75,2422,538,1254,0.429,220,565,0.389,318,689,0.462,0.517,212,243,0.872,108,393,501,571,119,30,245,237,1508
1476806,Lance stephenson,,31,46,1,814,147,323,0.455,27,90,0.3,120,233,0.515,0.497,63,80,0.788,12,115,127,165,24,4,72,96,384
3768342,Landry shamet,ES,24,69,14,1437,191,485,0.394,123,334,0.368,68,151,0.45,0.521,68,81,0.84,16,110,126,108,28,9,41,92,573
10690909,Larry nance jr.,AP,29,46,11,1040,129,247,0.522,23,70,0.329,106,177,0.599,0.569,40,57,0.702,72,176,248,81,43,20,37,84,321
15690909,Lauri markkanen,AP,24,61,61,1878,313,703,0.445,136,380,0.358,177,323,0.548,0.542,138,159,0.868,59,286,345,81,45,30,54,130,900
2353320,Leandro bolmaro,AL,21,35,2,241,17,54,0.315,5,18,0.278,12,36,0.333,0.361,11,13,0.846,16,27,43,21,6,0,13,26,50
41180544,Lebron james,AL,37,56,56,2084,640,1221,0.524,161,448,0.359,479,773,0.62,0.59,254,336,0.756,63,396,459,349,73,59,196,121,1695
4447896,Lonnie walker iv,ES,23,70,6,1612,311,764,0.407,111,353,0.314,200,411,0.487,0.48,116,148,0.784,18,163,181,152,44,19,71,98,849
18604651,Lonzo bal,BA,24,35,35,1212,162,383,0.423,110,260,0.423,52,123,0.423,0.567,21,28,0.75,35,155,190,178,64,31,82,85,455
5000000,Lou williams,BA,35,56,0,799,125,320,0.391,37,102,0.363,88,218,0.404,0.448,67,78,0.859,16,71,87,105,28,3,43,48,354
324372,Louis kin,AL,22,10,0,104,15,47,0.319,8,27,0.296,7,20,0.35,0.404,7,10,0.7,0,12,12,9,2,1,0,14,45
1782621,Luguentz dor,AL,22,51,51,1665,293,726,0.404,130,391,0.332,163,335,0.487,0.493,161,191,0.843,38,174,212,88,46,18,88,149,877
10174391,Luka dončić,BA,22,65,65,2301,641,1403,0.457,201,569,0.353,440,834,0.528,0.529,364,489,0.744,56,537,593,568,75,36,292,145,1847
925258,Luka garza,P,23,32,5,389,66,147,0.449,16,49,0.327,50,98,0.51,0.503,38,61,0.623,58,42,100,20,9,6,18,55,186
12727273,Luke kennard,ES,25,70,13,1919,287,639,0.449,190,423,0.449,97,216,0.449,0.598,69,77,0.896,20,209,229,146,42,6,60,101,833
606702,Luke kornet,P,26,15,0,103,13,27,0.481,0,5,0.0,13,22,0.591,0.481,4,6,0.667,13,16,29,9,3,3,0,9,30
2048040,Malachi flynn,BA,23,44,5,537,72,183,0.393,30,90,0.333,42,93,0.452,0.475,15,24,0.625,10,53,63,70,20,4,13,45,189
21700000,Malcolm brogdon,BA,29,36,36,1206,243,543,0.448,58,186,0.312,185,357,0.518,0.501,143,167,0.856,33,152,185,212,30,14,77,71,687
271197,Malcolm hil,,26,19,0,212,24,52,0.462,13,36,0.361,11,16,0.688,0.587,11,14,0.786,11,24,35,8,7,3,3,24,72
14491964,Malik beasley,ES,25,79,18,1976,332,850,0.391,240,637,0.377,92,213,0.432,0.532,49,60,0.817,26,201,227,116,43,12,43,88,953
1789256,Malik mon,ES,23,76,37,2139,391,826,0.473,173,442,0.391,218,384,0.568,0.578,93,117,0.795,37,219,256,218,61,29,122,138,1048
85578,Malik newman,BA,24,1,0,8,3,5,0.6,0,1,0.0,3,4,0.75,0.6,2,2,1.0,0,1,1,1,0,0,1,0,8
356734,Mamadi diakite,AP,25,13,3,188,25,47,0.532,0,5,0.0,25,42,0.595,0.532,6,11,0.545,17,42,59,2,5,9,7,33,56
241950,Marcus garrett,ES,23,12,0,128,5,21,0.238,1,4,0.25,4,17,0.235,0.262,2,5,0.4,9,14,23,7,5,3,2,16,13
15627907,Marcus morris,AP,32,54,54,1564,300,691,0.434,101,275,0.367,199,416,0.478,0.507,129,148,0.872,26,213,239,113,28,18,69,115,830
14339285,Marcus smart,BA,27,71,71,2296,300,718,0.418,119,360,0.331,181,358,0.506,0.501,142,179,0.793,42,228,270,417,119,18,159,160,861
16500000,Markelle fultz,BA,23,18,3,360,83,175,0.474,4,17,0.235,79,158,0.5,0.486,25,31,0.806,4,45,49,99,20,5,40,22,195
2641691,Markieff morris,AP,32,17,1,298,54,114,0.474,13,39,0.333,41,75,0.547,0.531,8,9,0.889,17,28,45,23,6,1,20,33,129
925258,Marko simonovic,P,22,9,0,35,4,15,0.267,1,5,0.2,3,10,0.3,0.3,8,11,0.727,5,5,10,0,1,1,2,6,17
1292900,Marquese chriss,AP,24,34,0,346,62,134,0.463,8,25,0.32,54,109,0.495,0.493,22,33,0.667,33,70,103,17,13,12,17,64,154
11312114,Marvin bagley iii,AP,22,48,25,1146,225,446,0.504,23,97,0.237,202,349,0.579,0.53,67,101,0.663,105,233,338,36,22,18,39,93,540
9248333,Mason plumlee,P,31,73,73,1793,205,320,0.641,0,2,0.0,205,318,0.645,0.641,67,171,0.392,176,389,565,226,61,52,100,224,477
2840160,Matisse thybulle,ES,24,66,50,1685,150,300,0.5,45,144,0.313,105,156,0.673,0.575,34,43,0.791,42,109,151,75,115,71,39,158,379
1669178,Matt thomas,ES,27,40,0,459,55,134,0.41,35,91,0.385,20,43,0.465,0.541,16,20,0.8,3,47,50,20,8,3,8,18,161
4330000,Maurice harkless,AL,28,47,24,863,83,181,0.459,31,101,0.307,52,80,0.65,0.544,20,28,0.714,12,100,112,23,29,24,31,77,217
1669178,Max strus,AL,25,68,16,1587,249,564,0.441,181,442,0.41,68,122,0.557,0.602,42,53,0.792,24,178,202,92,28,16,57,116,721
8975000,Maxi kleber,AP,30,59,21,1450,141,354,0.398,83,255,0.325,58,99,0.586,0.516,46,65,0.708,70,280,350,68,30,58,47,137,411
53176,Micah potter,P,23,3,0,31,5,11,0.455,0,2,0.0,5,9,0.556,0.455,2,2,1.0,4,5,9,0,1,1,1,4,12
5258735,Michael porter jr.,AL,23,9,9,265,37,103,0.359,10,48,0.208,27,55,0.491,0.408,5,9,0.556,9,50,59,17,10,2,12,16,89
5557725,Mikal bridges,AL,25,82,82,2854,458,858,0.534,115,312,0.369,343,546,0.628,0.601,131,157,0.834,74,273,347,185,96,36,68,150,1162
21000000,Mike conley,BA,34,72,72,2058,344,791,0.435,169,414,0.408,175,377,0.464,0.542,129,162,0.796,47,170,217,385,96,21,123,142,986
3500000,Mike muscala,P,30,43,0,592,113,248,0.456,70,163,0.429,43,85,0.506,0.597,48,57,0.842,21,108,129,22,18,26,14,58,344
5421493,Miles bridges,AP,23,80,80,2837,596,1214,0.491,154,465,0.331,442,749,0.59,0.554,267,333,0.802,90,469,559,300,74,67,150,193,1613
925258,Miles mcbride,BA,21,40,2,372,32,108,0.296,17,68,0.25,15,40,0.375,0.375,8,12,0.667,4,38,42,41,14,1,5,45,89
895930,Miye o,ES,24,16,0,44,2,9,0.222,1,8,0.125,1,1,1.0,0.278,0,1,0.0,1,6,7,5,0,0,1,7,5
7568743,Mo bamba,P,23,71,69,1824,296,617,0.48,107,281,0.381,189,336,0.563,0.566,57,73,0.781,148,424,572,85,38,118,77,182,756
8449074,Monte morris,BA,26,75,74,2239,374,773,0.484,124,314,0.395,250,459,0.545,0.564,73,84,0.869,27,199,226,333,56,14,78,92,945
9720900,Montrezl harrell,P,28,71,3,1641,358,555,0.645,4,17,0.235,354,538,0.658,0.649,212,296,0.716,149,282,431,145,29,43,72,137,932
1729217,Moritz wagner,P,24,63,3,960,197,396,0.497,66,201,0.328,131,195,0.672,0.581,104,129,0.806,42,190,232,87,20,13,56,123,564
3562080,Moses moody,ES,19,52,11,607,80,183,0.437,40,110,0.364,40,73,0.548,0.546,28,36,0.778,17,63,80,23,7,10,13,43,228
18000000,Myles turner,P,25,42,42,1235,200,393,0.509,61,183,0.333,139,210,0.662,0.587,79,105,0.752,65,232,297,44,28,118,54,119,540
1517981,Naji marshall,AL,24,55,4,735,109,269,0.405,21,105,0.2,88,164,0.537,0.444,74,93,0.796,38,104,142,62,33,8,46,69,313
2316240,Nassir little,AL,21,42,23,1088,145,315,0.46,51,154,0.331,94,161,0.584,0.541,69,94,0.734,58,178,236,54,25,36,40,82,410
1782621,Naz rei,P,22,77,6,1215,233,476,0.489,57,166,0.343,176,310,0.568,0.549,114,149,0.765,102,199,301,71,40,71,82,172,637
2089448,Nemanja bjelica,P,33,71,0,1142,160,342,0.468,54,149,0.362,106,193,0.549,0.547,59,81,0.728,62,232,294,159,41,26,87,128,433
8800000,Nerlens noe,P,27,25,11,562,32,60,0.533,0,3,0.0,32,57,0.561,0.533,21,30,0.7,48,93,141,23,30,31,20,67,85
3261480,Nickeil alexander-walker,ES,23,65,21,1466,253,680,0.372,105,338,0.311,148,342,0.433,0.449,81,109,0.743,37,150,187,156,46,23,93,103,692
3170029,Nicolas batum,AP,33,59,54,1462,179,387,0.463,108,270,0.4,71,117,0.607,0.602,25,38,0.658,29,225,254,100,58,42,40,80,491
423536,Nik stauskas,ES,28,8,0,39,5,14,0.357,4,10,0.4,1,4,0.25,0.5,4,6,0.667,1,2,3,2,0,0,1,1,18
31579390,Nikola jokić,P,26,74,74,2476,764,1311,0.583,97,288,0.337,667,1023,0.652,0.62,379,468,0.81,206,813,1019,584,109,63,281,191,2004
24000000,Nikola vučević,P,31,73,73,2418,546,1154,0.473,104,331,0.314,442,823,0.537,0.518,92,121,0.76,142,662,804,236,70,71,136,181,1288
15517242,Norman powell,,28,45,41,1458,279,605,0.461,106,253,0.419,173,352,0.491,0.549,189,233,0.811,20,125,145,96,42,21,69,106,853
5105160,Obi toppin,AP,23,72,10,1230,251,473,0.531,52,169,0.308,199,304,0.655,0.586,94,124,0.758,69,199,268,77,25,33,56,102,648
16071429,Og anunoby,AL,24,48,48,1728,309,697,0.443,115,317,0.363,194,380,0.511,0.526,89,118,0.754,74,190,264,125,71,25,80,131,822
236633,Olivier sar,P,22,22,2,421,58,101,0.574,13,29,0.448,45,72,0.625,0.639,24,29,0.828,34,59,93,19,6,15,22,52,153
1489065,Omer yurtseven,P,23,56,12,706,130,247,0.526,1,11,0.091,129,236,0.547,0.528,38,61,0.623,85,209,294,49,17,20,41,84,299
1701593,Oshae brissett,AL,23,67,25,1564,208,506,0.411,83,237,0.35,125,269,0.465,0.493,114,164,0.695,108,250,358,72,44,29,54,116,613
2389641,Otto porter jr.,AP,28,63,15,1396,193,416,0.464,80,216,0.37,113,200,0.565,0.56,49,61,0.803,86,276,362,94,68,29,37,83,515
7000000,P.j. tucker,AP,36,71,70,1981,207,428,0.484,80,193,0.415,127,235,0.54,0.577,45,61,0.738,100,287,387,149,58,15,66,161,539
4215120,P.j. washington,AP,23,65,28,1768,250,532,0.47,110,301,0.365,140,231,0.606,0.573,58,81,0.716,82,255,337,147,57,61,82,152,668
106352,Paris bas,AL,26,2,0,7,2,6,0.333,0,2,0.0,2,4,0.5,0.333,2,2,1.0,2,2,4,0,1,0,2,2,6
33003936,Pascal siakam,AP,27,68,68,2578,596,1207,0.494,75,218,0.344,521,989,0.527,0.525,284,379,0.749,128,452,580,360,85,42,181,225,1551
5333334,Pat connaughton,ES,29,65,19,1691,227,496,0.458,146,370,0.395,81,126,0.643,0.605,45,54,0.833,45,228,273,82,59,15,35,86,645
14320987,Patrick beverley,BA,33,58,54,1476,177,436,0.406,83,242,0.343,94,194,0.485,0.501,96,133,0.722,62,178,240,268,67,52,73,174,533
7422000,Patrick williams,AP,20,17,9,422,54,102,0.529,15,29,0.517,39,73,0.534,0.603,30,41,0.732,17,52,69,15,9,9,16,28,153
5890000,Patty mills,BA,33,81,48,2346,324,794,0.408,227,568,0.4,97,226,0.429,0.551,48,59,0.814,18,138,156,183,51,17,73,112,923
39344900,Paul george,AL,31,31,31,1077,268,636,0.421,91,257,0.354,177,379,0.467,0.493,127,148,0.858,12,201,213,176,67,13,126,74,754
2641691,Paul millsap,AP,36,33,1,376,45,115,0.391,8,35,0.229,37,80,0.463,0.426,17,24,0.708,41,73,114,29,10,13,19,67,115
1517981,Paul ree,P,22,38,2,302,54,96,0.563,2,8,0.25,52,88,0.591,0.573,6,14,0.429,44,48,92,16,33,14,10,57,116
462629,Paul watson,AL,27,9,3,156,12,35,0.343,6,26,0.231,6,9,0.667,0.429,1,2,0.5,3,24,27,8,3,3,4,10,31
2137440,Payton pritchard,ES,24,71,2,1001,160,373,0.429,101,245,0.412,59,128,0.461,0.564,21,21,1.0,32,102,134,139,25,6,41,61,442
220679,Petr cornelie,AP,26,13,0,38,5,15,0.333,1,8,0.125,4,7,0.571,0.367,3,4,0.75,7,7,14,3,1,1,4,7,14
1910860,Pj dozier,ES,25,18,0,340,36,99,0.364,15,48,0.313,21,51,0.412,0.439,10,13,0.769,14,49,63,29,11,6,13,33,97
2711280,Precious achiuwa,P,22,73,28,1725,265,603,0.439,56,156,0.359,209,447,0.468,0.486,78,131,0.595,146,327,473,82,37,41,84,151,664
2168760,Quentin grimes,ES,21,46,6,786,95,235,0.404,72,189,0.381,23,46,0.5,0.557,13,19,0.684,24,70,94,44,31,11,28,72,275
191860,Quinndary weatherspoon,ES,25,11,0,73,12,21,0.571,1,5,0.2,11,16,0.688,0.595,5,5,1.0,2,12,14,5,1,1,3,15,30
2303040,R.j. hampton,ES,20,64,14,1402,175,457,0.383,64,183,0.35,111,274,0.405,0.453,75,117,0.641,23,171,194,158,42,13,87,101,489
2641691,Rajon rondo,BA,35,39,1,697,68,176,0.386,31,88,0.352,37,88,0.42,0.474,19,26,0.731,15,93,108,170,30,6,68,56,186
2089448,Raul net,BA,29,70,19,1372,204,441,0.463,35,120,0.292,169,321,0.526,0.502,83,108,0.769,13,121,134,217,55,3,79,104,526
98779,Rayjon tucker,ES,24,5,0,71,6,9,0.667,4,5,0.8,2,4,0.5,0.889,5,7,0.714,3,5,8,10,4,0,1,5,21
9536000,Reggie bullock,AL,30,68,37,1902,201,501,0.401,141,392,0.36,60,109,0.55,0.542,40,48,0.833,33,208,241,83,41,14,40,111,583
10384500,Reggie jackson,ES,31,75,75,2337,479,1222,0.392,167,512,0.326,312,710,0.439,0.46,138,163,0.847,39,232,271,359,55,15,173,159,1263
256734,Reggie perry,AP,21,10,1,187,40,79,0.506,3,16,0.188,37,63,0.587,0.525,9,15,0.6,15,32,47,12,9,6,11,33,92
10384500,Richaun holmes,P,28,45,37,1074,198,300,0.66,2,5,0.4,196,295,0.664,0.663,70,90,0.778,93,224,317,48,17,41,56,128,468
17800000,Ricky rubio,BA,31,34,8,970,149,411,0.363,59,174,0.339,90,237,0.38,0.434,88,103,0.854,15,126,141,225,49,7,90,75,445
8623920,Rj barrett,AL,21,70,70,2417,487,1194,0.408,138,404,0.342,349,790,0.442,0.466,290,406,0.714,66,342,408,208,43,16,151,142,1402
12975471,Robert covington,,31,71,42,1940,209,498,0.42,128,339,0.378,81,159,0.509,0.548,58,69,0.841,59,332,391,92,103,91,75,190,604
3661976,Robert williams,P,24,61,61,1804,271,368,0.736,0,1,0.0,271,367,0.738,0.736,65,90,0.722,238,350,588,121,56,134,63,137,607
5000000,Robin lopez,P,33,36,9,612,110,199,0.553,2,6,0.333,108,193,0.56,0.558,32,54,0.593,68,58,126,54,2,18,44,67,254
2239544,Rodney hoo,,29,52,0,709,58,157,0.369,30,91,0.33,28,66,0.424,0.465,17,19,0.895,15,62,77,38,15,6,11,31,163
1939350,Rodney mcgruder,ES,30,51,2,754,98,225,0.436,58,146,0.397,40,79,0.506,0.564,19,26,0.731,31,80,111,48,21,7,24,58,273
3804360,Romeo langford,ES,22,48,5,771,83,191,0.435,29,85,0.341,54,106,0.509,0.51,23,42,0.548,30,78,108,21,22,16,16,47,218
8800000,Royce o'neale,AL,28,77,77,2406,203,444,0.457,119,306,0.389,84,138,0.609,0.591,45,56,0.804,64,304,368,191,86,32,79,183,570
5890000,Rudy gay,AP,35,55,1,1038,157,379,0.414,70,203,0.345,87,176,0.494,0.507,62,79,0.785,55,187,242,56,25,19,47,95,446
35344828,Rudy gobert,P,29,66,66,2120,362,508,0.713,0,4,0.0,362,504,0.718,0.713,303,439,0.69,241,727,968,72,45,137,119,176,1027
4916160,Rui hachimura,AP,23,42,13,943,187,381,0.491,55,123,0.447,132,258,0.512,0.563,46,66,0.697,25,135,160,48,23,9,33,53,475
44211146,Russell westbrook,BA,33,78,78,2678,548,1233,0.444,79,265,0.298,469,968,0.485,0.476,266,399,0.667,110,470,580,550,75,20,295,235,1441
1489065,Saben l,BA,22,37,0,604,69,177,0.39,14,60,0.233,55,117,0.47,0.429,56,71,0.789,18,69,87,107,36,12,36,44,208
2824320,Saddiq b,AL,22,82,82,2704,450,1136,0.396,211,610,0.346,239,526,0.454,0.489,210,254,0.827,107,334,441,233,73,16,96,128,1321
1517981,Sam merrill,ES,25,6,0,58,8,24,0.333,7,23,0.304,1,1,1.0,0.479,2,4,0.5,1,6,7,4,0,0,2,3,25
1994520,Santi aldama,AP,21,32,0,360,53,132,0.402,6,48,0.125,47,84,0.56,0.424,20,32,0.625,33,54,87,21,6,10,16,36,132
7280520,Scottie barnes,AP,20,74,74,2617,459,932,0.492,58,193,0.301,401,739,0.543,0.524,158,215,0.735,195,362,557,256,80,55,136,192,1134
1789256,Semi ojeleye,AP,27,30,0,406,30,99,0.303,15,50,0.3,15,49,0.306,0.379,23,29,0.793,27,47,74,9,7,6,9,30,98
9720900,Serge ibaka,,32,54,12,877,148,296,0.5,37,99,0.374,111,197,0.563,0.563,32,44,0.727,62,188,250,49,11,33,43,102,365
8207518,Seth curry,ES,31,64,64,2135,360,739,0.487,158,374,0.422,202,365,0.553,0.594,82,94,0.872,21,179,200,230,53,14,109,148,960
5495532,Shai gilgeous-alexander,BA,23,56,56,1942,477,1052,0.453,89,297,0.3,388,755,0.514,0.496,328,405,0.81,37,241,278,331,71,46,154,142,1371
1846738,Shake milton,BA,25,55,6,1179,173,403,0.429,43,133,0.323,130,270,0.481,0.483,61,73,0.836,30,112,142,139,28,17,44,99,450
496860,Skylar may,ES,24,28,5,220,32,64,0.5,8,25,0.32,24,39,0.615,0.563,8,9,0.889,5,20,25,17,7,0,10,9,80
17142857,Spencer dinwiddie,BA,28,67,51,1980,306,735,0.416,112,330,0.339,194,405,0.479,0.493,195,252,0.774,45,234,279,346,44,13,104,150,919
1248865,Stanley johnson,AP,25,48,27,1094,117,251,0.466,33,105,0.314,84,146,0.575,0.532,53,74,0.716,34,121,155,80,43,14,35,109,320
45780966,Stephen curry,BA,33,64,64,2211,535,1224,0.437,285,750,0.38,250,474,0.527,0.554,275,298,0.923,34,301,335,404,85,23,206,130,1630
3000000,Sterling brown,ES,26,49,3,628,59,155,0.381,28,92,0.304,31,63,0.492,0.471,14,15,0.933,26,123,149,34,14,7,23,56,160
17073171,Steven adams,P,28,76,75,1999,210,384,0.547,0,1,0.0,210,383,0.548,0.547,108,199,0.543,349,411,760,256,65,60,115,153,528
1729217,Svi mykhailiuk,AL,24,56,5,716,91,234,0.389,41,134,0.306,50,100,0.5,0.476,32,37,0.865,20,72,92,45,26,4,32,54,255
7500000,T.j. mcconnell,BA,29,27,8,652,100,208,0.481,10,33,0.303,90,175,0.514,0.505,19,23,0.826,20,70,90,131,29,10,29,53,229
4910000,Taj gibson,P,36,52,4,946,86,166,0.518,15,38,0.395,71,128,0.555,0.563,42,52,0.808,88,141,229,32,22,40,27,137,229
9500000,Talen horton-tucker,ES,21,60,19,1511,224,538,0.416,49,182,0.269,175,356,0.492,0.462,100,125,0.8,37,156,193,159,59,29,82,148,597
13000000,Taurean prince,AP,27,69,8,1177,177,390,0.454,86,229,0.376,91,161,0.565,0.564,62,82,0.756,26,148,174,68,47,23,53,116,502
1782621,Terance man,AL,25,81,33,2317,334,690,0.484,76,208,0.365,258,482,0.535,0.539,128,164,0.78,104,321,425,209,55,21,84,178,872
4000000,Terence davis,ES,24,30,11,536,113,267,0.423,49,149,0.329,64,118,0.542,0.515,36,44,0.818,11,83,94,40,25,11,33,70,311
12500000,Terrence ros,ES,30,63,0,1448,220,554,0.397,77,264,0.292,143,290,0.493,0.467,112,130,0.862,20,141,161,116,28,12,75,68,629
17905263,Terry rozier,ES,27,73,73,2458,518,1167,0.444,222,593,0.374,296,574,0.516,0.539,150,176,0.852,56,259,315,326,93,25,96,119,1408
321713,Terry taylor,ES,22,33,7,714,135,220,0.614,12,38,0.316,123,182,0.676,0.641,36,51,0.706,95,77,172,41,14,8,23,61,318
14190000,Thaddeus young,AP,33,52,1,845,141,272,0.518,17,48,0.354,124,224,0.554,0.55,23,49,0.469,80,128,208,104,54,18,52,81,322
1729217,Thanasis antetokounmpo,AL,29,48,6,473,70,128,0.547,2,14,0.143,68,114,0.596,0.555,29,46,0.63,40,61,101,22,16,12,26,68,171
2000000,Théo maledon,BA,20,51,7,908,119,317,0.375,44,150,0.293,75,167,0.449,0.445,79,100,0.79,20,111,131,111,31,11,65,67,361
440710,Theo pinson,AL,26,19,0,148,14,39,0.359,10,30,0.333,4,9,0.444,0.487,10,10,1.0,2,19,21,17,5,2,5,12,48
8666667,Thomas bryant,P,24,27,9,439,77,148,0.52,12,42,0.286,65,106,0.613,0.561,35,40,0.875,26,82,108,23,6,21,19,43,201
228709,Tim frazier,BA,31,12,3,208,14,45,0.311,6,17,0.353,8,28,0.286,0.378,5,9,0.556,5,14,19,34,3,1,15,27,39
21306816,Tim hardaway jr.,ES,29,42,20,1245,209,530,0.394,102,304,0.336,107,226,0.473,0.491,78,103,0.757,13,143,156,92,38,6,34,74,598
1939350,Timothé luwawu-cabarrot,AL,26,52,18,685,74,186,0.398,44,122,0.361,30,64,0.469,0.516,35,41,0.854,17,65,82,40,18,6,20,76,227
35995950,Tobias harris,AP,29,73,73,2543,493,1022,0.482,101,275,0.367,392,747,0.525,0.532,170,202,0.842,77,419,496,252,47,43,116,164,1257
9468119,Tomáš satoranský,ES,30,55,13,906,72,191,0.377,11,53,0.208,61,138,0.442,0.406,43,54,0.796,27,99,126,184,29,5,46,71,198
2389641,Tony snell,ES,30,53,12,823,69,171,0.404,45,128,0.352,24,43,0.558,0.535,4,4,1.0,16,87,103,28,16,9,19,70,187
4878049,Torrey craig,AL,31,78,16,1596,200,441,0.454,77,234,0.329,123,207,0.594,0.541,39,52,0.75,86,224,310,91,46,36,67,151,516
8326471,Trae young,BA,23,76,76,2652,711,1544,0.46,233,610,0.382,478,934,0.512,0.536,500,553,0.904,50,234,284,737,72,7,303,128,2155
1517981,Tre jones,BA,22,69,11,1148,166,339,0.49,10,51,0.196,156,288,0.542,0.504,71,91,0.78,29,126,155,233,42,7,46,78,413
2901240,Tre man,BA,20,60,26,1367,231,588,0.393,98,272,0.36,133,316,0.421,0.476,65,82,0.793,25,146,171,91,47,12,71,102,625
723190,Trendon watford,AL,21,48,10,869,142,267,0.532,9,38,0.237,133,229,0.581,0.549,71,94,0.755,57,142,199,81,25,28,44,116,364
471187,Trent forrest,BA,23,60,6,765,76,155,0.49,5,27,0.185,71,128,0.555,0.506,38,48,0.792,23,76,99,106,30,6,48,43,195
2641691,Trevor ariza,AL,36,24,11,462,33,99,0.333,20,74,0.27,13,25,0.52,0.434,10,18,0.556,10,72,82,27,13,6,11,20,96
3150000,Trey burke,BA,29,42,0,441,84,215,0.391,26,82,0.317,58,133,0.436,0.451,20,23,0.87,4,29,33,57,12,0,26,39,214
2500000,Trey lyles,AP,26,75,23,1537,262,562,0.466,67,209,0.321,195,353,0.552,0.526,195,243,0.802,89,290,379,88,29,32,73,123,786
3053760,Trey murphy iii,AL,21,62,1,864,109,277,0.394,71,186,0.382,38,91,0.418,0.522,45,51,0.882,47,100,147,38,23,7,16,60,334
8774289,Tristan thompson,AP,30,57,6,897,141,267,0.528,1,3,0.333,140,264,0.53,0.53,61,116,0.526,120,168,288,34,23,21,45,98,344
5170564,Troy brown jr.,AL,22,66,7,1055,108,258,0.419,47,133,0.353,61,125,0.488,0.51,20,26,0.769,39,164,203,66,36,5,26,62,283
2412840,Ty jerome,ES,24,48,4,801,124,328,0.378,54,186,0.29,70,142,0.493,0.46,38,47,0.809,19,59,78,109,30,5,37,73,340
4004280,Tyler herro,ES,22,66,10,2151,501,1122,0.447,175,439,0.399,326,683,0.477,0.525,190,219,0.868,32,297,329,263,44,8,174,95,1367
4023600,Tyrese haliburton,,21,77,77,2695,430,909,0.473,161,389,0.414,269,520,0.517,0.562,160,190,0.842,61,250,311,628,134,49,199,121,1181
2602920,Tyrese maxey,BA,21,75,74,2650,483,995,0.485,132,309,0.427,351,686,0.512,0.552,213,246,0.866,26,214,240,321,55,32,88,156,1311
198760,Tyrone wallace,ES,27,6,0,75,7,20,0.35,2,8,0.25,5,12,0.417,0.4,1,5,0.2,0,8,8,1,3,1,2,7,17
8376286,Tyus jones,BA,25,73,23,1549,249,552,0.451,80,205,0.39,169,347,0.487,0.524,54,66,0.818,17,159,176,324,66,2,46,32,632
2641691,Udonis haslem,P,41,13,0,83,14,31,0.452,1,4,0.25,13,27,0.481,0.468,3,3,1.0,4,21,25,4,1,1,5,15,32
2353320,Usman garuba,AP,19,24,2,239,19,44,0.432,5,20,0.25,14,24,0.583,0.489,5,7,0.714,21,62,83,17,10,11,6,28,48
2389641,Victor oladipo,ES,29,8,1,173,35,73,0.479,15,36,0.417,20,37,0.541,0.582,14,19,0.737,3,20,23,28,5,1,16,13,99
925258,Vit krejci,ES,21,30,8,690,68,167,0.407,32,98,0.327,36,69,0.522,0.503,19,22,0.864,18,83,101,57,19,8,29,65,187
1782621,Vlatko čančar,AP,24,15,1,176,23,41,0.561,7,12,0.583,16,29,0.552,0.646,9,14,0.643,8,23,31,17,2,3,9,18,62
2641691,Wayne ellington,ES,34,43,9,810,98,237,0.414,82,211,0.389,16,26,0.615,0.586,9,11,0.818,10,67,77,30,23,5,19,42,287
785104,Wayne selden,ES,27,3,0,19,1,4,0.25,1,2,0.5,0,2,0.0,0.375,2,4,0.5,0,1,1,1,0,0,0,1,5
6920027,Wendell carter jr.,P,22,62,61,1852,359,684,0.525,70,214,0.327,289,470,0.615,0.576,143,207,0.691,139,509,648,171,36,43,117,169,931
137789,Wenyen gabriel,AP,24,26,5,358,54,110,0.491,8,28,0.286,46,82,0.561,0.527,25,42,0.595,39,58,97,14,5,11,16,68,141
1802831,Wes iwundu,AL,27,3,1,82,8,18,0.444,3,5,0.6,5,13,0.385,0.528,3,4,0.75,3,10,13,0,1,0,1,8,22
1958495,Wesley matthews,ES,35,49,14,1002,87,220,0.395,53,157,0.338,34,63,0.54,0.516,22,28,0.786,30,62,92,36,23,8,18,87,249
15625000,Will barton,ES,31,71,71,2277,392,896,0.438,157,430,0.365,235,466,0.504,0.525,102,127,0.803,44,296,340,276,55,31,127,114,1043
4120083,Willie cauley-stein,P,28,20,2,183,16,35,0.457,1,2,0.5,15,33,0.455,0.471,1,2,0.5,13,27,40,10,6,3,7,19,34
2327220,Willy hernangómez,P,27,50,8,839,170,327,0.52,4,12,0.333,166,315,0.527,0.526,109,141,0.773,143,195,338,63,21,19,51,97,453
1517981,Xavier tillman sr.,AP,23,53,2,701,98,216,0.454,10,49,0.204,88,167,0.527,0.477,46,71,0.648,66,95,161,62,49,15,34,63,252
1762796,Yuta watanabe,AL,27,38,4,445,56,138,0.406,27,79,0.342,29,59,0.492,0.504,24,40,0.6,18,74,92,21,11,16,19,38,163
7000000,Zach collins,AP,24,28,4,502,76,155,0.49,14,41,0.341,62,114,0.544,0.535,52,65,0.8,46,107,153,61,13,23,45,67,218
19500000,Zach lavine,AL,26,67,67,2328,565,1186,0.476,185,475,0.389,380,711,0.534,0.554,320,375,0.853,22,286,308,303,41,23,171,120,1635
53176,Zavier simpson,BA,24,4,4,174,19,52,0.365,1,8,0.125,18,44,0.409,0.375,5,5,1.0,2,19,21,30,5,4,10,15,44
2498760,Zeke nnaji,AP,21,41,1,698,96,186,0.516,37,80,0.463,59,106,0.557,0.616,41,65,0.631,56,91,147,17,16,13,23,79,270
4373160,Ziaire williams,AL,20,62,31,1346,191,424,0.45,76,242,0.314,115,182,0.632,0.54,43,55,0.782,26,103,129,65,35,12,41,113,501
13906976,Brook lopez,P,34,78,78,2373,477,899,0.531,136,364,0.374,341,535,0.637,0.606,149,190,0.784,157,363,520,99,37,193,107,203,1239
33665040,Jrue holiday,BA,32,67,65,2183,490,1023,0.479,158,411,0.384,332,612,0.542,0.556,152,177,0.859,79,262,341,495,79,25,197,116,1290
42492492,Giannis antetokounmpo,AP,28,63,63,2024,707,1278,0.553,47,171,0.275,660,1107,0.596,0.572,498,772,0.645,137,605,742,359,52,51,246,197,1959
8500000,Grayson allen,ES,27,72,70,1972,245,557,0.44,146,366,0.399,99,191,0.518,0.571,114,126,0.905,61,176,237,163,62,14,72,117,750
10843350,Bobby portis,AP,27,70,22,1818,398,803,0.496,95,257,0.37,303,546,0.555,0.555,96,125,0.768,154,518,672,105,29,16,81,115,987
3925000,Jevon carter,BA,27,81,39,1810,239,565,0.423,142,337,0.421,97,228,0.425,0.549,31,38,0.816,35,167,202,197,66,29,78,158,651
5728393,Pat connaughton,AL,30,61,33,1443,165,421,0.392,109,322,0.339,56,99,0.566,0.521,27,41,0.659,50,233,283,77,37,11,33,69,466
6479000,Joe ingles,AL,35,46,0,1044,108,248,0.435,83,203,0.409,25,45,0.556,0.603,18,21,0.857,13,115,128,150,33,6,55,74,317
1836090,Wesley matthews,AL,36,52,0,820,58,160,0.363,39,124,0.315,19,36,0.528,0.484,24,28,0.857,34,79,113,34,20,13,18,71,179
37948276,Khris middleton,AL,31,33,19,801,177,406,0.436,51,162,0.315,126,244,0.516,0.499,92,102,0.902,28,112,140,163,23,5,71,68,497
2485200,Marjon beauchamp,AL,22,52,11,701,96,243,0.395,47,142,0.331,49,101,0.485,0.492,27,37,0.73,38,77,115,35,21,7,45,71,266
4000000,George hill,BA,36,35,0,668,59,132,0.447,23,74,0.311,36,58,0.621,0.534,34,46,0.739,13,54,67,89,19,3,27,41,175
2800000,Jordan nwora,AL,24,38,3,597,76,197,0.386,40,102,0.392,36,95,0.379,0.487,37,43,0.86,29,88,117,38,12,7,34,34,229
10183800,Jae crowder,AP,32,18,3,340,45,94,0.479,24,55,0.436,21,39,0.538,0.606,10,12,0.833,17,52,69,27,12,6,7,27,124
1878720,Thanasis antetokounmpo,AP,30,37,0,206,20,46,0.435,0,8,0.0,20,38,0.526,0.435,11,22,0.5,15,29,44,15,3,3,12,22,51
1836090,Serge ibaka,P,33,16,0,185,26,54,0.481,6,18,0.333,20,36,0.556,0.537,8,13,0.615,15,29,44,4,2,7,11,23,66
105522,Meyers leonard,P,30,9,2,114,14,29,0.483,7,18,0.389,7,11,0.636,0.603,8,9,0.889,12,22,34,1,2,0,6,16,43
1836090,Goran dragic,BA,36,7,0,83,14,36,0.389,7,17,0.412,7,19,0.368,0.486,4,4,1.0,3,9,12,12,2,0,7,2,39
30351780,Jayson tatum,AL,24,74,74,2732,727,1559,0.466,240,686,0.35,487,873,0.558,0.543,531,622,0.854,78,571,649,342,78,51,213,160,2225
28741071,Jaylen brown,AL,26,67,67,2405,679,1383,0.491,163,487,0.335,516,896,0.576,0.55,263,344,0.765,78,381,459,232,75,26,197,172,1784
16892857,Derrick white,ES,28,82,70,2319,350,758,0.462,149,391,0.381,201,367,0.548,0.56,168,192,0.875,52,241,293,321,54,76,95,177,1017
4306281,Grant williams,AP,24,79,23,2045,216,476,0.454,115,291,0.395,101,185,0.546,0.575,94,122,0.77,87,276,363,131,41,31,82,192,641
17457142,Marcus smart,BA,28,61,61,1957,250,602,0.415,115,342,0.336,135,260,0.519,0.511,88,118,0.746,46,145,191,382,93,23,143,172,703
26500000,Al horford,P,36,63,63,1922,228,479,0.476,145,325,0.446,83,154,0.539,0.627,15,21,0.714,73,317,390,189,30,61,37,121,616
22600000,Malcolm brogdon,BA,30,67,0,1744,354,732,0.484,132,297,0.444,222,435,0.51,0.574,160,184,0.87,42,238,280,248,45,18,98,109,1000
1637966,Sam hauser,AL,25,80,8,1290,180,396,0.455,140,335,0.418,40,61,0.656,0.631,12,17,0.706,35,169,204,71,29,21,30,99,512
10937502,Robert williams,P,25,35,20,824,127,170,0.747,0,1,0.0,127,169,0.751,0.747,25,41,0.61,104,188,292,50,22,48,34,68,279
2133278,Luke kornet,P,27,69,0,804,113,170,0.665,3,13,0.231,110,157,0.701,0.674,32,39,0.821,86,111,197,53,11,46,25,81,261
2239200,Payton pritchard,BA,25,48,3,643,101,245,0.412,56,154,0.364,45,91,0.495,0.527,12,16,0.75,25,63,88,64,14,1,40,37,270
1836090,Blake griffin,P,33,41,16,569,63,130,0.485,23,66,0.348,40,64,0.625,0.573,21,32,0.656,47,108,155,61,14,9,22,75,170
3500000,Mike muscala,P,31,20,4,323,42,89,0.472,25,65,0.385,17,24,0.708,0.612,9,13,0.692,14,54,68,12,4,5,9,28,118
1160955,Noah vonleh,P,27,23,1,171,11,24,0.458,1,4,0.25,10,20,0.5,0.479,2,2,1.0,18,30,48,7,2,8,11,35,25
1836090,Justin jackson,AL,27,23,0,107,7,27,0.259,5,20,0.25,2,7,0.286,0.352,1,2,0.5,2,15,17,9,4,4,2,7,20
37633050,Tobias harris,AL,30,74,74,2436,423,845,0.501,126,324,0.389,297,521,0.57,0.575,113,129,0.876,67,357,424,186,68,40,89,149,1085
33616770,Joel embiid,P,28,66,66,2284,728,1328,0.548,66,200,0.33,662,1128,0.587,0.573,661,771,0.857,113,557,670,274,66,112,226,205,2183
8250000,De'anthony melton,ES,24,77,58,2150,277,651,0.425,157,403,0.39,120,248,0.484,0.546,69,87,0.793,69,243,312,197,126,41,102,191,780
33000000,James harden,BA,33,58,58,2135,371,842,0.441,161,418,0.385,210,424,0.495,0.536,313,361,0.867,40,314,354,618,71,31,195,112,1216
2726880,Tyrese maxey,ES,22,60,41,2016,439,913,0.481,160,369,0.434,279,544,0.513,0.568,180,213,0.845,23,153,176,212,49,8,80,132,1218
10490000,P.j. tucker,AP,37,75,75,1920,96,225,0.427,55,140,0.393,41,85,0.482,0.549,19,23,0.826,95,200,295,60,39,15,44,180,266
1997718,Shake milton,ES,26,76,11,1567,241,503,0.479,56,148,0.378,185,355,0.521,0.535,99,116,0.853,39,152,191,240,25,13,94,123,637
3465000,Georges niang,AP,29,78,1,1512,222,502,0.442,154,384,0.401,68,118,0.576,0.596,39,45,0.867,19,166,185,77,30,14,54,145,637
1782621,Paul reed,P,23,69,2,755,124,209,0.593,1,6,0.167,123,203,0.606,0.596,38,51,0.745,112,150,262,27,46,51,45,123,287
2463490,Montrezl harrell,P,29,57,7,681,125,209,0.598,0,6,0.0,125,203,0.616,0.598,70,101,0.693,67,92,159,33,17,25,35,75,320
4379527,Matisse thybulle,AL,25,49,6,591,50,116,0.431,21,63,0.333,29,53,0.547,0.522,9,12,0.75,20,43,63,23,45,14,8,65,130
1930681,Jalen mcdaniels,AL,25,24,3,419,60,123,0.488,12,30,0.4,48,93,0.516,0.537,28,34,0.824,19,57,76,19,17,5,13,51,160
5000000,Furkan korkmaz,ES,25,37,0,353,48,111,0.432,18,46,0.391,30,65,0.462,0.514,26,36,0.722,6,36,42,22,10,3,24,18,140
2125200,Jaden springer,ES,20,16,2,89,17,35,0.486,2,5,0.4,15,30,0.5,0.514,6,8,0.75,6,8,14,8,7,3,3,15,42
4700000,Dewayne dedmon,P,33,8,1,76,13,22,0.591,1,2,0.5,12,20,0.6,0.614,1,5,0.2,6,19,25,10,2,5,6,14,28
8478720,Evan mobley,AP,21,79,79,2715,525,947,0.554,22,102,0.216,503,845,0.595,0.566,205,304,0.674,187,524,711,224,60,119,146,218,1277
8920795,Darius garland,BA,23,69,69,2447,522,1129,0.462,169,412,0.41,353,717,0.492,0.537,277,321,0.863,28,157,185,538,85,9,199,148,1490
30913750,Donovan mitchell,ES,26,68,68,2432,679,1402,0.484,245,635,0.386,434,767,0.566,0.572,319,368,0.867,63,226,289,301,99,27,180,168,1922
18796296,Caris levert,ES,28,74,30,2237,320,742,0.431,127,324,0.392,193,418,0.462,0.517,130,180,0.722,53,229,282,287,72,24,116,170,897
20000000,Jarrett allen,P,24,68,68,2220,403,626,0.644,1,10,0.1,402,616,0.653,0.645,162,221,0.733,221,445,666,113,54,84,93,153,969
7040880,Isaac okoro,AL,22,76,46,1652,175,354,0.494,62,171,0.363,113,183,0.617,0.582,78,103,0.757,52,135,187,87,56,30,42,158,490
7426088,Cedi osman,AL,27,77,2,1548,239,530,0.451,116,312,0.372,123,218,0.564,0.56,75,108,0.694,25,151,176,115,35,11,52,122,669
1782621,Lamar stevens,AL,25,62,25,1120,129,288,0.448,30,95,0.316,99,193,0.513,0.5,40,57,0.702,48,159,207,33,27,19,27,79,328
1930681,Dean wade,AP,26,44,13,891,73,177,0.412,45,127,0.354,28,50,0.56,0.54,15,23,0.652,20,130,150,37,28,21,17,89,206
27442830,Kevin love,AP,34,41,3,821,111,285,0.389,69,195,0.354,42,90,0.467,0.511,56,63,0.889,42,238,280,76,7,7,47,65,347
5853659,Ricky rubio,BA,32,33,2,566,61,178,0.343,21,82,0.256,40,96,0.417,0.402,28,35,0.8,9,61,70,115,26,6,31,51,171
1836090,Raul neto,BA,30,48,1,505,57,110,0.518,12,42,0.286,45,68,0.662,0.573,31,34,0.912,10,36,46,79,17,4,24,49,157
1836090,Robin lopez,P,34,37,2,299,48,75,0.64,2,4,0.5,46,71,0.648,0.653,14,18,0.778,23,28,51,19,2,8,25,43,112
9710528,Danny green,ES,35,8,0,95,19,38,0.5,13,29,0.448,6,9,0.667,0.671,1,1,1.0,2,8,10,4,5,3,7,10,52
105522,Sam merrill,ES,26,5,0,59,9,22,0.409,5,18,0.278,4,4,1.0,0.523,2,2,1.0,0,9,9,5,4,0,0,3,25
23760000,Julius randle,AP,28,77,77,2737,658,1432,0.459,218,636,0.343,440,796,0.553,0.536,402,531,0.757,141,626,767,316,49,21,216,233,1936
10900635,Rj barrett,ES,22,73,73,2475,510,1176,0.434,121,390,0.31,389,786,0.495,0.485,290,392,0.74,60,308,368,201,31,15,164,179,1431
27733332,Jalen brunson,BA,26,68,68,2379,587,1195,0.491,134,322,0.416,453,873,0.519,0.547,325,392,0.829,40,201,241,421,61,15,142,152,1633
2316240,Immanuel quickley,ES,23,81,21,2344,419,936,0.448,168,454,0.37,251,482,0.521,0.537,203,248,0.819,58,279,337,279,80,14,100,166,1209
2277000,Quentin grimes,ES,22,71,66,2121,282,602,0.468,157,407,0.386,125,195,0.641,0.599,78,98,0.796,49,180,229,150,47,26,69,177,799
7804879,Isaiah hartenstein,P,24,82,8,1626,175,327,0.535,8,37,0.216,167,290,0.576,0.547,48,71,0.676,209,327,536,102,53,64,66,213,406
5348280,Obi toppin,AP,24,67,5,1050,187,419,0.446,85,247,0.344,102,172,0.593,0.548,38,47,0.809,29,158,187,66,23,12,38,68,497
1639842,Jericho sims,P,24,52,16,812,83,107,0.776,0,1,0.0,83,106,0.783,0.776,12,16,0.75,99,143,242,25,15,28,27,96,178
1563518,Miles mcbride,BA,22,64,2,760,77,215,0.358,40,134,0.299,37,81,0.457,0.451,28,42,0.667,13,37,50,72,37,8,25,60,222
12960000,Josh hart,AL,27,25,1,750,92,157,0.586,27,52,0.519,65,105,0.619,0.672,45,57,0.789,47,129,176,90,34,12,38,62,256
18000000,Evan fournier,ES,30,27,7,459,56,166,0.337,35,114,0.307,21,52,0.404,0.443,18,21,0.857,4,45,49,36,16,3,22,46,165
5954454,Cam reddish,AL,23,20,8,438,61,136,0.449,17,56,0.304,44,80,0.55,0.511,29,33,0.879,7,24,31,20,15,8,15,32,168
14520730,Derrick rose,BA,34,27,0,338,61,159,0.384,19,63,0.302,42,96,0.438,0.443,11,12,0.917,8,32,40,46,7,5,22,18,152
1878720,Svi mykhailiuk,AL,25,13,0,40,6,12,0.5,6,10,0.6,0,2,0.0,0.75,3,5,0.6,0,7,7,1,1,0,2,1,21
9200000,Royce o'neale,AL,29,76,53,2409,229,593,0.386,163,419,0.389,66,174,0.379,0.524,50,69,0.725,55,329,384,283,65,49,114,239,671
8500000,Nic claxton,P,23,76,76,2271,414,587,0.705,0,2,0.0,414,585,0.708,0.705,133,246,0.541,184,518,702,144,65,189,96,212,961
18642857,Joe harris,AL,31,74,33,1527,201,440,0.457,142,333,0.426,59,107,0.551,0.618,18,28,0.643,23,141,164,101,34,13,41,140,562
38917057,Kyrie irving,BA,30,40,40,1478,398,819,0.486,130,348,0.374,268,471,0.569,0.565,158,179,0.883,38,166,204,211,41,33,91,109,1084
44119845,Kevin durant,AP,34,39,39,1403,410,734,0.559,71,189,0.376,339,545,0.622,0.607,267,286,0.934,14,248,262,207,32,57,136,92,1158
8496653,Seth curry,ES,32,61,7,1211,208,449,0.463,94,232,0.405,114,217,0.525,0.568,51,55,0.927,13,87,100,99,36,7,51,96,561
35448672,Ben simmons,BA,26,42,33,1105,133,235,0.566,0,2,0.0,133,233,0.571,0.566,25,57,0.439,40,223,263,256,54,24,97,139,291
2138160,Cam thomas,ES,21,57,4,948,201,456,0.441,51,133,0.383,150,323,0.464,0.497,151,174,0.868,8,87,95,78,20,7,63,55,604
1836090,Yuta watanabe,AL,28,58,1,928,114,232,0.491,60,135,0.444,54,97,0.557,0.621,34,47,0.723,30,111,141,48,25,17,22,80,322
20100000,Mikal bridges,ES,26,27,27,923,239,503,0.475,68,181,0.376,171,322,0.531,0.543,160,179,0.894,23,98,121,72,26,16,49,44,706
19500000,Spencer dinwiddie,BA,29,26,26,917,144,356,0.404,43,149,0.289,101,207,0.488,0.465,98,123,0.797,9,98,107,236,28,8,55,63,429
5887899,Cameron johnson,AP,26,25,25,770,141,301,0.468,58,156,0.372,83,145,0.572,0.565,74,87,0.851,20,100,120,52,35,8,27,54,414
1968175,Edmond sumner,ES,27,53,12,736,124,269,0.461,31,87,0.356,93,182,0.511,0.519,99,108,0.917,13,66,79,68,31,10,50,83,378
12939848,Dorian finney-smith,AP,29,26,26,721,67,191,0.351,37,121,0.306,30,70,0.429,0.448,15,19,0.789,47,81,128,41,17,16,26,64,186
6479000,Patty mills,BA,34,40,2,567,86,209,0.411,49,134,0.366,37,75,0.493,0.529,25,30,0.833,8,36,44,56,15,3,30,32,246
2109480,Day'ron sharpe,P,21,48,3,552,93,171,0.544,6,11,0.545,87,160,0.544,0.561,35,55,0.636,99,101,200,37,15,32,42,89,227
1836090,T.j. warren,AP,29,26,0,490,102,200,0.51,16,48,0.333,86,152,0.566,0.55,27,33,0.818,13,59,72,29,15,7,17,45,247
1836090,Markieff morris,AP,33,27,1,285,33,82,0.402,20,49,0.408,13,33,0.394,0.524,10,10,1.0,13,46,59,25,8,5,14,33,96
1637966,Kessler edwards,AL,22,14,1,79,6,24,0.25,2,12,0.167,4,12,0.333,0.292,1,2,0.5,6,8,14,2,3,1,4,3,15
30351780,Bam adebayo,P,25,75,75,2598,602,1114,0.54,1,12,0.083,601,1102,0.545,0.541,324,402,0.806,184,504,688,240,88,61,187,208,1529
5722116,Tyler herro,ES,23,67,67,2337,487,1109,0.439,203,537,0.378,284,572,0.497,0.531,170,182,0.934,27,333,360,280,51,16,158,101,1347
1815677,Max strus,AL,26,80,33,2272,324,790,0.41,197,563,0.35,127,227,0.559,0.535,78,89,0.876,49,209,258,171,42,12,70,166,923
37653300,Jimmy butler,AP,33,64,64,2138,479,888,0.539,36,103,0.35,443,785,0.564,0.56,472,555,0.85,141,234,375,340,117,21,101,80,1466
6479000,Caleb martin,AL,27,71,49,2077,254,548,0.464,84,236,0.356,170,312,0.545,0.54,91,113,0.805,88,256,344,117,71,31,78,145,683
1815677,Gabe vincent,BA,26,68,34,1759,228,567,0.402,117,350,0.334,111,217,0.512,0.505,68,78,0.872,27,118,145,167,62,5,92,154,641
28333334,Kyle lowry,BA,36,55,44,1718,196,485,0.404,107,310,0.345,89,175,0.509,0.514,116,135,0.859,43,182,225,281,57,21,103,143,615
8750000,Victor oladipo,ES,30,42,2,1106,160,403,0.397,70,212,0.33,90,191,0.471,0.484,59,79,0.747,16,112,128,146,57,12,87,99,449
1752638,Haywood highsmith,AP,26,54,11,969,93,216,0.431,37,109,0.339,56,107,0.523,0.516,13,28,0.464,57,131,188,43,36,17,45,82,236
16902000,Duncan robinson,AL,28,42,1,691,88,237,0.371,63,192,0.328,25,45,0.556,0.504,29,32,0.906,8,61,69,46,14,0,28,77,268
517060,Cody zeller,P,30,15,2,217,37,59,0.627,0,2,0.0,37,57,0.649,0.627,24,35,0.686,25,39,64,10,3,4,14,33,98
2239920,Nikola jovic,AP,19,15,8,204,28,69,0.406,8,35,0.229,20,34,0.588,0.464,18,19,0.947,9,22,31,10,7,2,10,19,82
1752638,Omer yurtseven,P,24,9,0,83,16,27,0.593,3,7,0.429,13,20,0.65,0.648,5,6,0.833,8,15,23,2,2,2,4,16,40
1836090,Udonis haslem,P,42,7,1,71,10,29,0.345,3,9,0.333,7,20,0.35,0.397,4,5,0.8,4,7,11,0,1,2,1,11,27
58493,Jamaree bouyea,BA,23,4,0,65,6,13,0.462,2,5,0.4,4,8,0.5,0.538,1,2,0.5,1,4,5,4,4,2,4,5,15
16571120,Dejounte murray,ES,26,74,74,2693,612,1319,0.464,133,387,0.344,479,932,0.514,0.514,158,190,0.832,53,336,389,448,112,19,160,106,1515
37096500,Trae young,BA,24,73,73,2541,597,1390,0.429,154,460,0.335,443,930,0.476,0.485,566,639,0.886,56,161,217,741,80,9,300,104,1914
23500000,John collins,AP,25,71,71,2130,359,707,0.508,70,240,0.292,289,467,0.619,0.557,143,178,0.803,77,385,462,85,42,73,79,220,931
9835881,De'andre hunter,AL,25,67,67,2126,379,822,0.461,100,286,0.35,279,536,0.521,0.522,171,207,0.826,46,238,284,94,35,17,82,199,1029
6395160,Onyeka okongwu,P,22,80,18,1849,317,497,0.638,4,13,0.308,313,484,0.647,0.642,153,196,0.781,217,359,576,81,56,107,81,251,791
18706897,Clint capela,P,28,65,63,1730,350,536,0.653,0,1,0.0,350,535,0.654,0.653,79,131,0.603,258,459,717,58,45,79,54,139,779
18000000,Bogdan bogdanovic,ES,30,54,9,1508,273,611,0.447,146,360,0.406,127,251,0.506,0.566,64,77,0.831,23,142,165,150,43,18,65,86,756
3536160,Aj griffin,AL,19,72,12,1401,248,533,0.465,101,259,0.39,147,274,0.536,0.56,42,47,0.894,37,116,153,73,42,12,42,87,639
2792640,Jalen johnson,AL,21,70,6,1042,158,322,0.491,30,104,0.288,128,218,0.587,0.537,49,78,0.628,51,231,282,83,38,34,41,113,395
1836090,Aaron holiday,BA,26,63,6,845,92,220,0.418,36,88,0.409,56,132,0.424,0.5,27,32,0.844,25,49,74,89,37,12,36,79,247
2959080,Saddiq bey,AL,23,25,7,629,108,230,0.47,50,125,0.4,58,105,0.552,0.578,25,29,0.862,39,81,120,34,20,1,17,37,291
1836090,Frank kaminsky,P,29,26,0,176,25,44,0.568,11,23,0.478,14,21,0.667,0.693,10,12,0.833,3,33,36,21,5,1,9,21,71
1563518,Vit krejci,BA,22,29,0,165,15,37,0.405,5,21,0.238,10,16,0.625,0.473,1,2,0.5,6,20,26,17,5,1,5,17,36
2000000,Garrison mathews,ES,26,9,0,84,13,31,0.419,10,25,0.4,3,6,0.5,0.581,7,8,0.875,1,10,11,3,1,1,1,6,43
1017781,Tyrese martin,ES,23,16,0,66,9,23,0.391,1,7,0.143,8,16,0.5,0.413,2,2,1.0,5,7,12,2,1,0,2,2,21
2717391,Bruno fernando,P,24,8,0,41,11,19,0.579,0,3,0.0,11,16,0.688,0.579,5,6,0.833,6,9,15,1,0,3,5,6,27
7644600,Scottie barnes,AL,21,77,76,2678,463,1016,0.456,63,224,0.281,400,792,0.505,0.487,190,246,0.772,179,333,512,371,83,61,154,170,1179
35448672,Pascal siakam,AP,28,71,71,2652,630,1313,0.48,93,287,0.324,537,1026,0.523,0.515,367,474,0.774,131,425,556,415,65,36,169,228,1720
21250000,Fred vanvleet,BA,28,69,69,2535,437,1112,0.393,207,606,0.342,230,506,0.455,0.486,254,283,0.898,30,250,280,495,123,38,140,193,1335
17357143,Og anunoby,AL,25,67,67,2386,421,885,0.476,142,367,0.387,279,518,0.539,0.556,140,167,0.838,95,237,332,131,128,50,132,200,1124
12690000,Chris boucher,AP,30,76,0,1523,261,529,0.493,62,189,0.328,199,340,0.585,0.552,128,168,0.762,157,264,421,29,47,64,41,143,712
2840160,Precious achiuwa,P,23,55,12,1140,196,404,0.485,29,108,0.269,167,296,0.564,0.521,87,124,0.702,100,228,328,50,31,30,59,102,508
1500000,Christian koloko,P,22,58,19,802,72,150,0.48,1,12,0.083,71,138,0.514,0.483,37,59,0.627,84,87,171,31,21,57,20,128,182
8000000,Thaddeus young,AP,34,54,9,795,108,198,0.545,6,34,0.176,102,164,0.622,0.561,18,26,0.692,71,95,166,75,54,5,42,88,240
2145720,Malachi flynn,BA,24,53,2,691,87,242,0.36,47,133,0.353,40,109,0.367,0.457,25,33,0.758,15,61,76,70,21,4,25,65,246
1836090,Juancho hernangomez,AP,27,42,10,614,48,114,0.421,17,67,0.254,31,47,0.66,0.496,9,16,0.563,27,96,123,25,16,6,15,43,122
1563518,Dalano banton,BA,23,31,2,279,55,130,0.423,15,51,0.294,40,79,0.506,0.481,17,24,0.708,11,34,45,36,13,13,18,34,142
14375000,Will barton,ES,32,16,2,211,28,79,0.354,14,42,0.333,14,37,0.378,0.443,2,2,1.0,5,21,26,17,11,3,3,17,72
6667500,Khem birch,P,30,20,0,162,19,32,0.594,1,2,0.5,18,30,0.6,0.609,4,5,0.8,8,17,25,7,5,5,8,24,43
37096500,Zach lavine,ES,27,77,77,2768,673,1388,0.485,204,544,0.375,469,844,0.556,0.558,363,428,0.848,42,303,345,327,69,18,194,159,1913
22000000,Nikola vucevic,P,32,82,82,2746,597,1148,0.52,121,347,0.349,476,801,0.594,0.573,132,158,0.835,159,744,903,265,60,57,139,179,1447
27300000,Demar derozan,AL,33,74,74,2682,657,1303,0.504,46,142,0.324,611,1161,0.526,0.522,456,523,0.872,34,309,343,377,83,36,153,186,1816
7775400,Patrick williams,AP,21,82,65,2323,314,677,0.464,115,277,0.415,199,400,0.498,0.549,90,105,0.857,78,249,327,100,72,70,101,147,833
1563518,Ayo dosunmu,ES,23,80,51,2098,281,570,0.493,59,189,0.312,222,381,0.583,0.545,66,82,0.805,45,175,220,206,62,26,99,182,687
7413955,Coby white,ES,22,74,2,1730,263,594,0.443,128,344,0.372,135,250,0.54,0.551,61,70,0.871,16,196,212,204,54,6,74,122,715
9030000,Alex caruso,BA,28,67,36,1575,130,286,0.455,55,151,0.364,75,135,0.556,0.551,59,73,0.808,42,154,196,193,98,46,77,159,374
3200000,Andre drummond,P,29,67,0,849,166,274,0.606,0,3,0.0,166,271,0.613,0.606,67,125,0.536,138,306,444,33,45,27,75,117,399
13000000,Patrick beverley,BA,34,22,22,605,47,119,0.395,25,81,0.309,22,38,0.579,0.5,8,15,0.533,20,87,107,76,23,16,18,63,127
1815677,Javonte green,AL,29,32,1,480,61,108,0.565,13,35,0.371,48,73,0.658,0.625,30,45,0.667,27,61,88,23,24,21,20,52,165
3191400,Dalen terry,ES,20,38,0,214,32,72,0.444,7,27,0.259,25,45,0.556,0.493,14,21,0.667,12,25,37,22,11,5,8,24,85
1563518,Terry taylor,AP,23,5,0,36,9,10,0.9,1,1,1.0,8,9,0.889,0.95,1,4,0.25,5,3,8,0,0,1,0,2,20
2036318,Tony bradley,P,25,12,0,33,6,12,0.5,3,5,0.6,3,7,0.429,0.625,4,4,1.0,1,10,11,1,1,1,1,2,19
1563518,Marko simonovic,P,23,7,0,20,2,7,0.286,1,4,0.25,1,3,0.333,0.357,1,2,0.5,1,1,2,0,0,0,0,5,6
21177750,Buddy hield,AL,30,80,73,2482,475,1038,0.458,288,677,0.425,187,361,0.518,0.596,106,129,0.822,67,333,400,225,92,26,139,156,1344
6586800,Bennedict mathurin,ES,20,78,17,2222,413,951,0.434,100,310,0.323,313,641,0.488,0.487,376,454,0.828,87,231,318,116,48,13,152,162,1302
2244111,Andrew nembhard,ES,23,75,63,2073,284,644,0.441,92,263,0.35,192,381,0.504,0.512,49,62,0.79,35,164,199,341,70,13,126,179,709
4215120,Tyrese haliburton,BA,22,56,56,1883,412,841,0.49,161,402,0.4,251,439,0.572,0.586,175,201,0.871,33,172,205,585,91,25,141,69,1160
35069500,Myles turner,P,26,62,62,1825,402,733,0.548,93,249,0.373,309,484,0.638,0.612,216,276,0.783,88,378,466,89,36,140,103,215,1113
3804360,Aaron nesmith,AL,23,73,60,1816,252,590,0.427,115,314,0.366,137,276,0.496,0.525,119,142,0.838,62,215,277,98,55,34,75,235,738
8100000,T.j. mcconnell,BA,30,75,6,1526,283,521,0.543,26,59,0.441,257,462,0.556,0.568,58,68,0.853,45,189,234,397,81,10,143,105,650
4670160,Jalen smith,P,22,68,31,1279,242,508,0.476,54,191,0.283,188,317,0.593,0.53,104,137,0.759,129,265,394,66,21,60,72,153,642
1846738,Oshae brissett,AP,24,65,2,1083,123,319,0.386,48,155,0.31,75,164,0.457,0.461,104,145,0.717,62,156,218,44,33,13,34,79,398
2573760,Isaiah jackson,P,21,63,12,1042,179,318,0.563,2,14,0.143,177,304,0.582,0.566,95,146,0.651,113,169,282,51,31,93,51,154,455
3936960,Chris duarte,AL,25,46,12,897,123,333,0.369,55,174,0.316,68,159,0.428,0.452,61,72,0.847,19,96,115,64,25,9,41,65,362
4765339,Goga bitadze,P,23,21,0,202,27,52,0.519,4,14,0.286,23,38,0.605,0.558,11,24,0.458,25,24,49,18,9,10,12,34,69
590926,James johnson,AP,35,18,1,162,22,49,0.449,3,15,0.2,19,34,0.559,0.48,4,8,0.5,4,26,30,15,7,6,8,32,51
8694369,Daniel theis,P,30,7,1,109,21,44,0.477,2,11,0.182,19,33,0.576,0.5,5,12,0.417,7,15,22,9,2,6,3,7,49
330000,Trevelin queen,ES,25,7,0,70,7,29,0.241,2,15,0.133,5,14,0.357,0.276,5,5,1.0,8,9,17,6,2,5,7,4,21
13000000,Kyle kuzma,AP,27,64,64,2239,512,1142,0.448,160,481,0.333,352,661,0.533,0.518,173,237,0.73,55,408,463,239,36,29,190,145,1357
33833400,Kristaps porzingis,P,27,65,65,2120,507,1018,0.498,137,356,0.385,370,662,0.559,0.565,354,416,0.851,114,432,546,174,58,100,137,196,1505
3552840,Corey kispert,AL,23,74,45,2093,291,585,0.497,163,384,0.424,128,201,0.637,0.637,75,88,0.852,33,174,207,87,32,9,55,97,820
4916160,Deni avdija,AL,22,76,40,2020,253,579,0.437,69,232,0.297,184,347,0.53,0.497,122,165,0.739,74,413,487,211,65,29,123,209,697
9125000,Monte morris,BA,27,62,61,1695,247,515,0.48,78,204,0.382,169,311,0.543,0.555,64,77,0.831,26,184,210,326,43,13,60,75,636
43279250,Bradley beal,ES,29,50,50,1673,444,878,0.506,80,219,0.365,364,659,0.552,0.551,192,228,0.842,41,155,196,271,45,33,145,107,1160
7804878,Delon wright,BA,30,50,14,1221,138,291,0.474,41,119,0.345,97,172,0.564,0.545,52,60,0.867,58,122,180,194,92,17,44,59,369
6263188,Rui hachimura,AP,24,30,0,728,158,324,0.488,30,89,0.337,128,235,0.545,0.534,44,58,0.759,19,109,128,35,11,12,36,39,390
1836090,Anthony gill,AP,30,59,8,624,71,132,0.538,4,29,0.138,67,103,0.65,0.553,49,67,0.731,37,62,99,34,7,12,15,70,195
1836090,Taj gibson,P,37,49,2,480,65,125,0.52,8,24,0.333,57,101,0.564,0.552,30,42,0.714,32,61,93,34,15,12,26,84,168
5250000,Kendrick nunn,ES,27,31,0,436,89,199,0.447,38,97,0.392,51,102,0.5,0.543,18,20,0.9,10,44,54,56,17,4,35,31,234
4810320,Johnny davis,ES,20,28,5,423,66,171,0.386,17,70,0.243,49,101,0.485,0.436,14,27,0.519,10,55,65,28,10,8,17,48,163
140384,Xavier cooks,AP,27,10,1,126,17,28,0.607,0,1,0.0,17,27,0.63,0.607,4,10,0.4,16,22,38,6,6,4,8,13,38
1575000,Isaiah todd,AP,21,6,1,61,3,19,0.158,1,10,0.1,2,9,0.222,0.184,2,2,1.0,2,10,12,4,1,0,2,4,9
5258280,Franz wagner,AL,21,80,80,2609,542,1118,0.485,130,360,0.361,412,758,0.544,0.543,271,322,0.842,70,259,329,283,77,17,167,183,1485
11055120,Paolo banchero,AP,20,72,72,2430,479,1122,0.427,85,285,0.298,394,837,0.471,0.465,394,534,0.738,84,413,497,269,60,39,200,160,1437
16500000,Markelle fultz,BA,24,60,60,1778,349,679,0.514,27,87,0.31,322,592,0.544,0.534,112,143,0.783,69,165,234,341,87,26,139,131,837
3613680,Cole anthony,BA,22,60,4,1552,277,610,0.454,75,206,0.364,202,404,0.5,0.516,152,170,0.894,47,241,288,235,37,31,91,158,781
2200000,Bol bol,AP,23,70,33,1505,261,478,0.546,30,113,0.265,231,365,0.633,0.577,82,108,0.759,69,336,405,69,30,85,112,92,634
6922320,Jalen suggs,ES,21,53,19,1246,186,444,0.419,66,202,0.327,120,242,0.496,0.493,86,119,0.723,55,106,161,155,67,27,94,120,524
13000000,Gary harris,ES,28,48,42,1184,138,307,0.45,94,218,0.431,44,89,0.494,0.603,27,30,0.9,21,77,98,59,45,12,28,93,397
1878720,Moritz wagner,P,25,57,18,1109,198,396,0.5,51,163,0.313,147,233,0.631,0.564,153,182,0.841,69,190,259,84,37,13,68,136,600
10581484,Terrence ross,ES,31,42,9,944,129,299,0.431,61,160,0.381,68,139,0.489,0.533,15,20,0.75,10,75,85,54,25,8,37,53,334
2000000,Caleb houstan,AL,20,51,4,812,66,182,0.363,46,136,0.338,20,46,0.435,0.489,15,18,0.833,34,65,99,30,12,7,18,63,193
3433320,Chuma okeke,AL,24,27,8,518,43,122,0.352,26,86,0.302,17,36,0.472,0.459,16,21,0.762,26,70,96,37,19,11,17,40,128
2412840,R.j. hampton,ES,21,26,0,361,50,114,0.439,18,53,0.34,32,61,0.525,0.518,31,37,0.838,9,30,39,34,16,4,21,22,149
17400000,Jonathan isaac,AP,25,11,0,124,22,53,0.415,6,15,0.4,16,38,0.421,0.472,5,9,0.556,15,29,44,6,14,4,4,5,55
652829,Michael carter-williams,BA,31,4,0,44,6,14,0.429,1,3,0.333,5,11,0.455,0.464,4,7,0.571,1,4,5,7,1,1,4,5,17
5808435,P.j. washington,AP,24,73,73,2380,434,978,0.444,149,428,0.348,285,550,0.518,0.52,127,174,0.73,73,285,358,175,66,79,110,193,1144
21486316,Terry rozier,ES,28,63,63,2221,493,1188,0.415,165,505,0.327,328,683,0.48,0.484,178,220,0.809,51,208,259,319,74,16,134,119,1329
30075000,Gordon hayward,AL,32,50,50,1577,276,581,0.475,52,160,0.325,224,421,0.532,0.52,129,159,0.811,33,182,215,206,42,12,99,70,733
8623920,Lamelo ball,BA,21,36,36,1268,296,721,0.411,144,383,0.376,152,338,0.45,0.51,102,122,0.836,42,189,231,304,46,11,129,118,838
1782621,Nick richards,P,25,65,9,1217,197,313,0.629,1,1,1.0,196,312,0.628,0.631,137,183,0.749,147,269,416,38,11,71,59,154,532
1563518,Jt thor,AP,20,69,8,969,95,238,0.399,39,123,0.317,56,115,0.487,0.481,33,47,0.702,36,116,152,36,22,23,44,66,262
1900000,Theo maledon,BA,21,44,7,854,102,254,0.402,28,95,0.295,74,159,0.465,0.457,63,74,0.851,14,109,123,152,37,12,59,61,295
2909040,Kai jones,P,22,46,0,550,67,120,0.558,4,19,0.211,63,101,0.624,0.575,19,26,0.731,37,86,123,15,17,30,31,65,157
4362240,James bouknight,ES,22,34,0,515,69,193,0.358,33,109,0.303,36,84,0.429,0.443,20,30,0.667,8,64,72,41,14,5,32,49,191
7000000,Cody martin,AL,27,7,0,134,14,36,0.389,3,14,0.214,11,22,0.5,0.431,4,7,0.571,8,16,24,11,4,1,2,13,35
7252200,Jaden ivey,ES,20,74,73,2304,409,983,0.416,120,350,0.343,289,633,0.457,0.477,266,356,0.747,73,215,288,387,61,17,237,242,1204
5837760,Killian hayes,BA,21,76,56,2154,307,815,0.377,80,286,0.28,227,529,0.429,0.426,92,112,0.821,28,193,221,470,104,28,173,219,786
19550000,Bojan bogdanovic,AP,33,59,59,1893,430,882,0.488,145,353,0.411,285,529,0.539,0.57,268,303,0.884,36,187,223,152,34,8,135,113,1273
4124280,Jalen duren,P,19,67,31,1670,258,398,0.648,0,2,0.0,258,396,0.652,0.648,96,157,0.611,229,366,595,75,44,59,92,182,612
3433320,Isaiah stewart,P,21,50,47,1414,195,441,0.442,67,205,0.327,128,236,0.542,0.518,110,149,0.738,115,288,403,70,20,34,68,133,567
5155500,Cory joseph,BA,31,62,2,1227,150,351,0.427,70,180,0.389,80,171,0.468,0.527,57,72,0.792,21,85,106,217,34,9,56,88,427
1563518,Isaiah livers,AP,24,52,22,1199,120,288,0.417,74,203,0.365,46,85,0.541,0.545,32,39,0.821,28,115,143,41,28,28,30,103,346
10012800,Alec burks,ES,31,51,8,1122,200,459,0.436,99,239,0.414,101,220,0.459,0.544,153,188,0.814,19,139,158,114,38,8,58,98,652
5200000,Hamidou diallo,AL,24,56,0,996,215,375,0.573,5,21,0.238,210,354,0.593,0.58,87,148,0.588,57,137,194,55,53,16,71,124,522
9603360,James wiseman,P,21,24,22,605,130,245,0.531,3,18,0.167,127,227,0.559,0.537,42,59,0.712,55,139,194,16,4,20,37,69,305
3000000,Kevin knox,AL,23,42,1,593,84,179,0.469,43,116,0.371,41,63,0.651,0.589,26,33,0.788,20,88,108,15,14,12,32,74,237
1836090,Rodney mcgruder,ES,31,32,12,524,62,152,0.408,41,97,0.423,21,55,0.382,0.543,18,22,0.818,20,54,74,28,16,1,11,39,183
10552800,Cade cunningham,BA,21,12,12,400,93,224,0.415,17,61,0.279,76,163,0.466,0.453,36,43,0.837,12,62,74,72,10,7,39,34,239
94136,Eugene omoruyi,AL,25,17,4,373,57,134,0.425,17,58,0.293,40,76,0.526,0.489,34,47,0.723,21,38,59,17,14,3,18,45,165
14004703,Kentavious caldwell-pope,ES,29,76,76,2381,292,632,0.462,135,319,0.423,157,313,0.502,0.569,103,125,0.824,35,173,208,183,112,35,86,145,822
33047803,Nikola jokic,P,27,69,69,2323,646,1022,0.632,57,149,0.383,589,873,0.675,0.66,341,415,0.822,167,650,817,678,87,47,247,174,1690
6479000,Bruce brown,AL,26,80,31,2280,358,741,0.483,91,254,0.358,267,487,0.548,0.545,116,153,0.758,63,265,328,268,87,51,123,190,923
31650600,Jamal murray,BA,25,65,65,2133,473,1041,0.454,172,432,0.398,301,609,0.494,0.537,180,216,0.833,48,209,257,400,66,16,145,103,1298
19690909,Aaron gordon,AP,27,68,68,2055,429,761,0.564,60,173,0.347,369,588,0.628,0.603,191,314,0.608,164,282,446,203,54,51,98,129,1109
2808600,Christian braun,ES,21,76,6,1181,143,289,0.495,34,96,0.354,109,193,0.565,0.554,40,64,0.625,48,133,181,59,41,17,35,101,360
4500000,Jeff green,AP,36,56,4,1091,160,328,0.488,30,104,0.288,130,224,0.58,0.534,87,117,0.744,38,106,144,69,18,17,46,99,437
2234359,Vlatko cancar,AP,25,60,9,889,108,227,0.476,43,115,0.374,65,112,0.58,0.57,38,41,0.927,24,104,128,80,22,14,37,84,297
2201520,Bones hyland,BA,22,42,1,820,173,434,0.399,91,241,0.378,82,193,0.425,0.503,71,82,0.866,10,76,86,125,28,13,67,66,508
2617800,Zeke nnaji,AP,22,53,5,728,110,196,0.561,17,65,0.262,93,131,0.71,0.605,40,62,0.645,65,73,138,18,17,23,31,105,277
1836090,Deandre jordan,P,34,39,8,586,88,115,0.765,1,1,1.0,87,114,0.763,0.77,22,48,0.458,52,150,202,34,12,23,48,71,199
4725000,Ish smith,BA,34,43,0,398,52,131,0.397,2,12,0.167,50,119,0.42,0.405,2,4,0.5,5,49,54,100,8,7,44,33,108
10876844,Reggie jackson,BA,32,16,2,319,49,128,0.383,19,68,0.279,30,60,0.5,0.457,10,12,0.833,3,25,28,50,9,1,19,22,127
1902133,Davon reed,ES,27,35,1,315,25,80,0.313,16,44,0.364,9,36,0.25,0.413,15,20,0.75,9,46,55,19,13,4,20,36,81
1836090,Thomas bryant,P,25,18,1,205,33,68,0.485,4,9,0.444,29,59,0.492,0.515,13,18,0.722,19,41,60,2,2,7,10,25,83
2193960,Peyton watson,ES,20,23,2,186,29,59,0.492,6,14,0.429,23,45,0.511,0.542,11,20,0.55,8,29,37,11,2,11,8,14,75
11400000,Dillon brooks,AL,27,73,73,2214,392,991,0.396,143,439,0.326,249,552,0.451,0.468,120,154,0.779,45,199,244,189,65,16,104,240,1047
12119440,Ja morant,BA,23,61,59,1948,566,1214,0.466,92,300,0.307,474,914,0.519,0.504,372,497,0.748,61,296,357,493,66,16,206,100,1596
15000000,Tyus jones,BA,26,80,22,1940,311,710,0.438,121,326,0.371,190,384,0.495,0.523,80,100,0.8,28,172,200,417,83,6,74,32,823
2130240,Desmond bane,ES,24,58,58,1841,450,939,0.479,166,407,0.408,284,532,0.534,0.568,181,205,0.883,43,248,291,254,56,22,126,150,1247
2094120,Santi aldama,AP,22,77,20,1682,247,525,0.47,94,266,0.353,153,259,0.591,0.56,108,144,0.75,85,286,371,97,45,48,60,143,696
2300000,John konchar,AL,26,72,23,1494,138,320,0.431,60,177,0.339,78,143,0.545,0.525,28,36,0.778,64,246,310,100,77,25,37,112,364
2588640,David roddy,AP,21,70,4,1258,180,420,0.429,65,212,0.307,115,208,0.553,0.506,41,65,0.631,50,143,193,59,29,19,57,107,466
17926829,Steven adams,P,29,42,42,1133,157,263,0.597,0,1,0.0,157,262,0.599,0.597,47,129,0.364,214,271,485,97,36,46,79,98,361
4343920,Brandon clarke,AP,26,56,8,1090,229,349,0.656,1,6,0.167,228,343,0.665,0.658,99,137,0.723,92,218,310,72,34,37,55,131,558
14415545,Luke kennard,ES,26,24,3,590,90,171,0.526,74,137,0.54,16,34,0.471,0.743,18,19,0.947,9,66,75,54,13,1,16,35,272
4591680,Ziaire williams,AL,21,37,4,561,84,196,0.429,25,97,0.258,59,99,0.596,0.492,17,22,0.773,16,63,79,35,14,6,37,58,210
3047640,Jake laravia,AP,21,35,0,414,37,95,0.389,24,71,0.338,13,24,0.542,0.516,7,9,0.778,19,44,63,21,12,4,18,49,105
1200000,Kennedy chandler,BA,20,36,0,281,35,83,0.422,2,15,0.133,33,68,0.485,0.434,6,13,0.462,9,29,38,58,12,5,18,15,78
18500000,Domantas sabonis,P,26,79,79,2736,577,938,0.615,31,83,0.373,546,855,0.639,0.632,325,438,0.742,251,722,973,573,65,39,230,279,1510
18352273,Harrison barnes,AP,30,82,82,2662,374,791,0.473,132,353,0.374,242,438,0.553,0.556,350,413,0.847,87,279,366,128,57,10,86,103,1230
30351780,De'aaron fox,BA,25,73,73,2435,682,1331,0.512,119,367,0.324,563,964,0.584,0.557,343,440,0.78,40,266,306,447,83,23,181,172,1826
8008440,Keegan murray,AL,22,80,78,2382,354,782,0.453,206,501,0.411,148,281,0.527,0.584,62,81,0.765,89,282,371,98,61,42,60,162,976
14508929,Kevin huerter,ES,24,75,75,2203,420,866,0.485,205,510,0.402,215,356,0.604,0.603,95,131,0.725,42,209,251,221,80,24,97,181,1140
9472219,Malik monk,ES,24,77,0,1719,357,796,0.448,143,398,0.359,214,398,0.538,0.538,184,207,0.889,32,171,203,298,49,20,146,125,1041
4833600,Davion mitchell,BA,24,80,9,1447,181,399,0.454,63,197,0.32,118,202,0.584,0.533,25,31,0.806,16,89,105,185,44,15,62,112,450
2625000,Trey lyles,AP,27,74,0,1247,187,408,0.458,87,240,0.363,100,168,0.595,0.565,101,124,0.815,68,232,300,66,27,31,64,97,562
4000000,Terence davis,ES,25,64,5,841,154,364,0.423,89,243,0.366,65,121,0.537,0.545,34,43,0.791,20,119,139,67,43,12,53,104,431
1910860,Chimezie metu,AP,25,66,0,689,129,219,0.589,9,38,0.237,120,181,0.663,0.61,54,73,0.74,47,151,198,40,22,21,32,81,321
11215260,Richaun holmes,P,29,42,1,348,55,89,0.618,5,8,0.625,50,81,0.617,0.646,15,19,0.789,29,51,80,9,3,11,14,50,130
1902133,Kz okpala,AP,23,35,3,248,16,38,0.421,7,21,0.333,9,17,0.529,0.513,7,8,0.875,7,27,34,13,7,7,7,39,46
1836090,Matthew dellavedova,BA,32,32,0,213,17,50,0.34,9,27,0.333,8,23,0.348,0.43,4,7,0.571,1,12,13,41,7,0,10,20,47
3918600,Alex len,P,29,26,2,161,16,30,0.533,0,2,0.0,16,28,0.571,0.533,11,16,0.688,24,36,60,12,4,11,16,28,43
30913750,Deandre ayton,P,24,67,67,2035,522,887,0.589,7,24,0.292,515,863,0.597,0.592,152,200,0.76,172,495,667,115,37,53,120,190,1203
5121951,Torrey craig,AP,32,79,60,1948,228,500,0.456,100,253,0.395,128,247,0.518,0.556,32,45,0.711,145,281,426,117,50,62,73,179,588
28400000,Chris paul,BA,37,59,59,1889,294,668,0.44,98,261,0.375,196,407,0.482,0.513,133,160,0.831,27,224,251,524,91,22,114,126,819
33833400,Devin booker,ES,26,53,53,1835,527,1067,0.494,111,316,0.351,416,751,0.554,0.546,306,358,0.855,46,194,240,293,51,18,145,159,1471
1836090,Damion lee,ES,30,74,5,1506,200,452,0.442,110,247,0.445,90,205,0.439,0.564,94,104,0.904,39,186,225,99,30,7,78,118,604
1836090,Josh okogie,ES,24,72,26,1350,162,414,0.391,66,197,0.335,96,217,0.442,0.471,139,192,0.724,109,142,251,105,56,34,63,114,529
1563518,Jock landale,P,27,69,4,979,178,337,0.528,21,84,0.25,157,253,0.621,0.559,79,105,0.752,119,161,280,68,16,30,59,126,456
6000000,Cameron payne,BA,28,48,15,968,188,453,0.415,68,185,0.368,120,268,0.448,0.49,49,64,0.766,12,94,106,214,33,8,81,88,493
125000,Ish wainright,AL,28,60,2,915,84,227,0.37,57,173,0.329,27,54,0.5,0.496,26,31,0.839,45,94,139,53,38,22,22,117,251
9500000,Landry shamet,ES,25,40,9,807,113,300,0.377,75,199,0.377,38,101,0.376,0.502,45,51,0.882,11,56,67,93,26,5,36,61,346
9240000,Dario saric,AP,28,37,12,533,76,178,0.427,27,69,0.391,49,109,0.45,0.503,36,44,0.818,39,103,142,57,13,5,36,69,215
4264629,Darius bazley,P,22,7,0,61,12,25,0.48,2,8,0.25,10,17,0.588,0.52,2,5,0.4,5,11,16,6,3,5,5,9,28
10123457,Ivica zubac,P,25,76,76,2170,326,514,0.634,0,2,0.0,326,512,0.637,0.634,166,238,0.697,236,520,756,77,29,98,117,219,818
42492492,Paul george,AL,32,56,56,1939,459,1004,0.457,158,426,0.371,301,578,0.521,0.536,256,294,0.871,45,297,342,288,83,20,176,159,1332
1930681,Terance mann,ES,26,81,36,1872,272,524,0.519,77,198,0.389,195,326,0.598,0.593,92,118,0.78,77,199,276,184,42,22,80,149,713
16372093,Marcus morris,AP,33,65,65,1825,274,643,0.426,112,308,0.364,162,335,0.484,0.513,68,87,0.782,29,229,258,114,42,21,56,136,728
42492492,Kawhi leonard,AL,31,52,50,1748,446,871,0.512,104,250,0.416,342,621,0.551,0.572,243,279,0.871,57,281,338,204,72,28,88,84,1239
10843350,Nicolas batum,AP,34,78,19,1709,160,381,0.42,124,317,0.391,36,64,0.563,0.583,34,48,0.708,62,237,299,121,54,44,50,149,478
16758621,Norman powell,ES,29,60,8,1567,340,710,0.479,114,287,0.397,226,423,0.534,0.559,225,277,0.812,24,151,175,109,50,18,101,125,1019
12307692,Robert covington,AP,32,48,0,779,102,229,0.445,54,136,0.397,48,93,0.516,0.563,30,40,0.75,31,135,166,57,38,33,32,86,288
40866760,John wall,BA,32,34,3,755,138,338,0.408,33,109,0.303,105,229,0.459,0.457,77,113,0.681,14,78,92,178,27,12,80,59,386
46295265,Russell westbrook,BA,34,21,21,635,128,262,0.489,26,73,0.356,102,189,0.54,0.538,50,76,0.658,30,72,102,160,23,10,71,41,332
3395062,Amir coffey,AL,25,50,9,625,56,145,0.386,11,40,0.275,45,105,0.429,0.424,49,63,0.778,17,36,53,53,7,5,21,50,172
19568360,Eric gordon,ES,34,22,11,547,81,175,0.463,47,111,0.423,34,64,0.531,0.597,32,38,0.842,4,33,37,47,13,8,21,33,241
1563518,Jason preston,BA,23,14,0,124,18,41,0.439,5,18,0.278,13,23,0.565,0.5,0,2,0.0,2,20,22,27,2,0,10,7,41
3901399,Jordan poole,BA,23,82,43,2458,550,1278,0.43,214,637,0.336,336,641,0.524,0.514,361,415,0.87,32,193,225,369,63,21,252,214,1675
25806468,Draymond green,AP,32,73,73,2297,250,474,0.527,40,131,0.305,210,343,0.612,0.57,77,108,0.713,66,459,525,500,74,60,204,229,617
40600080,Klay thompson,AL,32,69,69,2279,546,1252,0.436,301,731,0.412,245,521,0.47,0.556,116,132,0.879,39,247,286,163,49,29,123,130,1509
8000000,Kevon looney,P,26,82,70,1958,242,384,0.63,0,1,0.0,242,383,0.632,0.63,94,155,0.606,274,486,760,207,52,50,45,225,578
48070014,Stephen curry,BA,34,56,56,1941,559,1133,0.493,273,639,0.427,286,494,0.579,0.614,257,281,0.915,39,302,341,352,52,20,179,117,1648
4500000,Donte divincenzo,ES,26,72,36,1894,235,540,0.435,150,378,0.397,85,162,0.525,0.574,58,71,0.817,80,245,325,252,97,10,112,133,678
5739840,Jonathan kuminga,AP,20,67,16,1394,261,497,0.525,54,146,0.37,207,351,0.59,0.579,90,138,0.652,70,161,231,125,41,31,95,157,666
33616770,Andrew wiggins,AL,27,37,37,1190,250,529,0.473,89,225,0.396,161,304,0.53,0.557,44,72,0.611,61,125,186,85,45,28,48,107,633
3740160,Moses moody,ES,20,63,3,817,108,227,0.476,49,135,0.363,59,92,0.641,0.584,37,53,0.698,28,77,105,51,18,7,34,54,302
4220057,Ty jerome,ES,25,45,2,816,118,242,0.488,35,90,0.389,83,152,0.546,0.56,38,41,0.927,7,71,78,135,23,5,30,64,309
5571403,Jamychal green,AP,32,57,1,797,136,252,0.54,42,111,0.378,94,141,0.667,0.623,52,67,0.776,72,133,205,51,25,23,52,105,366
1836090,Andre iguodala,AP,39,8,0,113,7,15,0.467,1,9,0.111,6,6,1.0,0.5,2,3,0.667,3,14,17,19,4,3,9,11,17
1017781,Ryan rollins,BA,20,12,0,62,7,20,0.35,3,9,0.333,4,11,0.364,0.425,6,6,1.0,3,9,12,6,1,1,16,10,23
1836090,Dennis schroder,BA,29,66,50,1986,270,650,0.415,74,225,0.329,196,425,0.461,0.472,216,252,0.857,21,144,165,298,50,10,112,145,830
44474988,Lebron james,AP,38,55,54,1954,609,1219,0.5,121,377,0.321,488,842,0.58,0.549,251,327,0.768,65,392,457,375,50,32,178,88,1590
37980720,Anthony davis,P,29,56,54,1904,542,962,0.563,19,74,0.257,523,888,0.589,0.573,348,444,0.784,195,507,702,148,59,114,122,146,1451
1563518,Austin reaves,ES,24,64,22,1843,259,490,0.529,86,216,0.398,173,274,0.631,0.616,229,265,0.864,33,160,193,215,33,19,99,108,833
1878720,Wenyen gabriel,P,25,68,2,1024,155,260,0.596,10,36,0.278,145,224,0.647,0.615,52,84,0.619,116,170,286,36,26,35,46,144,372
4374000,Jarred vanderbilt,AP,23,26,24,625,74,140,0.529,10,33,0.303,64,107,0.598,0.564,29,37,0.784,49,124,173,42,30,6,29,57,187
15558035,Malik beasley,ES,26,26,14,621,105,268,0.392,66,187,0.353,39,81,0.481,0.515,13,21,0.619,8,78,86,31,21,1,30,32,289
31377750,D'angelo russell,BA,26,17,17,526,107,221,0.484,46,111,0.414,61,110,0.555,0.588,36,49,0.735,7,43,50,103,10,8,39,23,296
1017781,Max christie,ES,19,41,3,512,44,106,0.415,26,62,0.419,18,44,0.409,0.538,14,16,0.875,7,68,75,21,9,7,13,33,128
1836090,Juan toscano-anderson,AL,29,30,7,365,33,66,0.5,4,20,0.2,29,46,0.63,0.53,11,15,0.733,14,47,61,25,10,7,17,46,81
2298385,Damian jones,P,27,22,1,176,20,37,0.541,0,3,0.0,20,34,0.588,0.541,15,20,0.75,18,37,55,4,3,12,9,17,55
442439,Matt ryan,AL,25,12,0,129,15,49,0.306,13,35,0.371,2,14,0.143,0.439,4,5,0.8,2,12,14,4,2,0,3,14,47
10733400,Anthony edwards,ES,21,79,79,2842,707,1541,0.459,213,578,0.369,494,963,0.513,0.528,319,422,0.756,47,411,458,350,125,58,259,186,1946
2161440,Jaden mcdaniels,AL,22,79,79,2416,370,716,0.517,107,269,0.398,263,447,0.588,0.591,106,144,0.736,92,215,307,148,74,76,112,272,953
38172414,Rudy gobert,P,30,70,70,2148,360,546,0.659,0,3,0.0,360,543,0.663,0.659,219,340,0.644,231,583,814,87,56,95,122,210,939
8780488,Kyle anderson,AP,29,69,46,1957,252,495,0.509,43,105,0.41,209,390,0.536,0.553,100,136,0.735,66,302,368,335,78,63,103,146,647
1930681,Jaylen nowell,ES,23,65,2,1252,280,625,0.448,67,232,0.289,213,393,0.542,0.502,77,99,0.778,36,134,170,132,42,5,65,101,704
1930681,Naz reid,P,23,68,11,1251,310,577,0.537,75,217,0.346,235,360,0.653,0.602,86,127,0.677,73,260,333,77,42,53,92,176,781
7295000,Taurean prince,AP,28,54,4,1192,177,379,0.467,74,194,0.381,103,185,0.557,0.565,65,77,0.844,15,117,132,84,28,15,69,123,493
1836090,Austin rivers,ES,30,52,10,1016,91,209,0.435,43,123,0.35,48,86,0.558,0.538,30,39,0.769,5,78,83,75,28,4,23,80,255
33833400,Karl-anthony towns,AP,27,29,29,957,212,428,0.495,60,164,0.366,152,264,0.576,0.565,118,135,0.874,48,188,236,140,20,17,86,111,602
22680000,Mike conley,BA,35,24,24,753,108,235,0.46,58,138,0.42,50,97,0.515,0.583,63,73,0.863,16,59,75,120,29,4,29,45,337
2160000,Jordan mclaughlin,BA,26,43,0,678,61,145,0.421,24,78,0.308,37,67,0.552,0.503,15,18,0.833,15,47,62,148,32,4,33,28,161
5009633,Nickeil alexander-walker,ES,24,23,0,356,48,125,0.384,26,72,0.361,22,53,0.415,0.488,13,21,0.619,7,35,42,32,8,7,10,30,135
1836090,Nathan knight,P,25,38,0,291,46,81,0.568,8,22,0.364,38,59,0.644,0.617,39,57,0.684,22,34,56,13,10,6,21,41,139
1836090,Bryn forbes,ES,29,25,0,268,30,83,0.361,14,46,0.304,16,37,0.432,0.446,15,15,1.0,4,11,15,17,7,2,12,22,89
1017781,Josh minott,AL,20,15,0,96,18,36,0.5,2,6,0.333,16,30,0.533,0.528,8,8,1.0,5,20,25,5,4,6,3,10,46
33333333,Cj mccollum,BA,31,75,75,2649,587,1344,0.437,211,543,0.389,376,801,0.469,0.515,183,238,0.769,55,273,328,429,70,38,183,153,1568
14700000,Jonas valanciunas,P,30,79,79,1968,446,816,0.547,38,109,0.349,408,707,0.577,0.57,185,224,0.826,225,579,804,140,20,52,159,245,1115
1785000,Herbert jones,AP,24,66,66,1951,235,501,0.469,56,167,0.335,179,334,0.536,0.525,123,161,0.764,97,172,269,162,103,42,88,208,649
1782621,Naji marshall,AL,25,77,21,1792,247,571,0.433,66,218,0.303,181,353,0.513,0.49,138,175,0.789,48,231,279,189,54,14,97,113,698
31650600,Brandon ingram,AL,25,45,45,1538,404,835,0.484,64,164,0.39,340,671,0.507,0.522,240,272,0.882,23,223,246,262,32,19,148,116,1112
1563518,Jose alvarado,BA,24,61,10,1310,201,489,0.411,83,247,0.336,118,242,0.488,0.496,65,80,0.813,28,113,141,186,67,10,81,125,550
5508600,Dyson daniels,BA,19,59,11,1042,87,208,0.418,27,86,0.314,60,122,0.492,0.483,26,40,0.65,36,152,188,134,43,11,57,99,227
13534817,Zion williamson,AP,22,29,29,956,285,469,0.608,7,19,0.368,278,450,0.618,0.615,177,248,0.714,58,144,202,133,32,16,99,65,754
11550000,Devonte' graham,BA,27,53,0,811,85,231,0.368,66,190,0.347,19,41,0.463,0.511,44,59,0.746,12,60,72,116,30,10,27,48,280
6803012,Jaxson hayes,P,22,47,2,610,86,156,0.551,3,29,0.103,83,127,0.654,0.561,58,83,0.699,39,93,132,34,20,19,31,67,233
12196094,Josh richardson,ES,29,23,4,533,62,148,0.419,33,86,0.384,29,62,0.468,0.53,16,21,0.762,11,45,56,37,29,9,23,47,173
2443581,Willy hernangomez,P,28,38,2,458,89,169,0.527,3,11,0.273,86,158,0.544,0.536,81,104,0.779,58,122,180,33,17,13,39,64,262
5155500,Garrett temple,ES,36,25,0,162,18,45,0.4,11,26,0.423,7,19,0.368,0.522,3,4,0.75,5,12,17,13,9,2,4,15,50
30913750,Shai gilgeous-alexander,BA,24,68,68,2416,704,1381,0.51,58,168,0.345,646,1213,0.533,0.531,669,739,0.905,59,270,329,371,112,65,192,192,2135
6287400,Josh giddey,AP,20,76,76,2367,539,1118,0.482,76,234,0.325,463,884,0.524,0.516,106,145,0.731,148,451,599,469,57,31,211,143,1260
4341480,Jalen williams,ES,21,75,62,2276,414,794,0.521,73,205,0.356,341,589,0.579,0.567,155,191,0.812,84,253,337,248,103,35,123,191,1056
15277778,Luguentz dort,AL,23,74,73,2272,339,873,0.388,135,409,0.33,204,464,0.44,0.466,200,259,0.772,128,216,344,154,75,23,92,243,1013
1836090,Isaiah joe,ES,23,73,10,1395,224,508,0.441,161,394,0.409,63,114,0.553,0.599,82,100,0.82,27,148,175,88,48,8,39,105,691
1563518,Aaron wiggins,ES,24,70,14,1297,186,363,0.512,48,122,0.393,138,241,0.573,0.579,59,71,0.831,68,142,210,80,39,15,55,110,479
2000000,Kenrich williams,AP,28,53,10,1206,179,346,0.517,50,134,0.373,129,212,0.608,0.59,17,39,0.436,97,164,261,105,45,14,32,112,425
3046200,Tre mann,BA,21,67,5,1183,197,501,0.393,81,257,0.315,116,244,0.475,0.474,42,55,0.764,27,128,155,120,40,11,62,99,517
2000000,Jaylin williams,P,20,49,36,914,102,234,0.436,46,113,0.407,56,121,0.463,0.534,38,54,0.704,44,197,241,76,28,12,37,111,288
2000000,Jeremiah robinson-earl,AP,22,43,20,814,110,248,0.444,37,111,0.333,73,137,0.533,0.518,35,42,0.833,71,109,180,43,24,11,19,71,292
3261480,Aleksej pokusevski,AP,21,34,25,701,108,249,0.434,38,104,0.365,70,145,0.483,0.51,22,35,0.629,45,114,159,64,20,43,43,58,276
4569840,Ousmane dieng,AP,19,39,1,569,76,181,0.42,26,98,0.265,50,83,0.602,0.492,15,23,0.652,19,86,105,46,14,7,26,42,193
37096500,Luka doncic,BA,23,66,66,2391,719,1449,0.496,185,541,0.342,534,908,0.588,0.56,515,694,0.742,54,515,569,529,90,33,236,166,2138
10012800,Reggie bullock,AL,31,78,55,2364,192,470,0.409,151,397,0.38,41,73,0.562,0.569,26,37,0.703,32,251,283,108,54,13,36,166,561
14317459,Christian wood,P,27,67,17,1738,396,769,0.515,105,279,0.376,291,490,0.594,0.583,217,281,0.772,87,404,491,121,30,72,121,169,1114
3098400,Josh green,ES,22,60,21,1539,205,382,0.537,68,169,0.402,137,213,0.643,0.626,68,94,0.723,55,127,182,103,42,5,72,156,546
11080125,Dwight powell,P,31,76,64,1458,197,269,0.732,0,5,0.0,197,264,0.746,0.732,112,168,0.667,149,165,314,69,48,26,65,209,506
9000000,Maxi kleber,AP,31,37,5,930,77,169,0.456,39,112,0.348,38,57,0.667,0.571,27,38,0.711,30,105,135,52,12,30,27,85,220
1017781,Jaden hardy,ES,20,48,5,708,146,333,0.438,63,156,0.404,83,177,0.469,0.533,65,79,0.823,11,78,89,65,17,7,46,64,420
2036318,Frank ntilikina,ES,24,47,5,607,48,132,0.364,17,67,0.254,31,65,0.477,0.428,22,33,0.667,7,55,62,58,16,7,29,65,135
16000000,Davis bertans,AP,30,45,1,492,69,160,0.431,55,141,0.39,14,19,0.737,0.603,13,15,0.867,10,43,53,21,11,8,10,53,206
5461219,Javale mcgee,P,35,42,7,355,80,125,0.64,2,5,0.4,78,120,0.65,0.648,24,41,0.585,30,77,107,11,4,26,36,54,186
1836090,Theo pinson,ES,27,40,1,323,31,87,0.356,22,62,0.355,9,25,0.36,0.483,11,13,0.846,10,53,63,46,6,1,12,34,95
27431078,Kemba walker,BA,32,9,1,144,24,57,0.421,7,28,0.25,17,29,0.586,0.482,17,21,0.81,3,13,16,19,2,2,4,11,72
464299,Facundo campazzo,BA,31,8,0,52,3,13,0.231,3,11,0.273,0,2,0.0,0.346,1,2,0.5,0,2,2,9,6,0,3,3,10
16475454,Lauri markkanen,AP,25,66,66,2273,571,1145,0.499,200,511,0.391,371,634,0.585,0.586,349,399,0.875,130,440,570,123,42,38,127,137,1691
13340000,Jordan clarkson,ES,30,61,61,1988,458,1031,0.444,155,459,0.338,303,572,0.53,0.519,200,245,0.816,72,174,246,270,33,13,186,120,1271
12804878,Kelly olynyk,P,31,68,68,1942,278,557,0.499,93,236,0.394,185,321,0.576,0.583,198,232,0.853,82,338,420,252,60,37,168,232,847
2696400,Walker kessler,P,21,74,40,1703,298,414,0.72,1,3,0.333,297,411,0.723,0.721,82,159,0.516,231,389,620,69,26,173,58,169,679
10260000,Talen horton-tucker,ES,22,65,20,1313,257,613,0.419,58,203,0.286,199,410,0.485,0.467,126,168,0.75,41,169,210,246,41,29,126,108,698
3918360,Ochai agbaji,ES,22,59,22,1209,165,386,0.427,81,228,0.355,84,158,0.532,0.532,56,69,0.812,43,78,121,67,16,15,41,99,467
16500000,Collin sexton,BA,24,48,15,1145,237,468,0.506,48,122,0.393,189,346,0.546,0.558,163,199,0.819,37,68,105,138,27,6,85,112,685
6184500,Rudy gay,AP,36,56,0,816,109,287,0.38,33,130,0.254,76,157,0.484,0.437,42,49,0.857,33,130,163,57,19,18,37,68,293
3205128,Simone fontecchio,AL,27,52,6,766,115,312,0.369,63,191,0.33,52,121,0.43,0.47,35,44,0.795,31,55,86,42,15,8,39,62,328
105522,Kris dunn,BA,28,22,3,568,116,216,0.537,17,36,0.472,99,180,0.55,0.576,41,53,0.774,9,91,100,124,25,10,35,58,290
105522,Luka samanic,AP,23,7,4,161,26,57,0.456,8,31,0.258,18,26,0.692,0.526,9,13,0.692,0,30,30,15,6,2,10,17,69
105522,Jarrell brantley,AP,26,4,0,39,8,14,0.571,4,9,0.444,4,5,0.8,0.714,2,2,1.0,1,5,6,3,0,2,2,3,22
20955000,Jerami grant,AP,28,63,63,2246,434,913,0.475,144,359,0.401,290,554,0.523,0.554,278,342,0.813,53,230,283,150,51,53,116,152,1290
22321429,Anfernee simons,ES,23,62,62,2171,467,1045,0.447,212,562,0.377,255,483,0.528,0.548,160,179,0.894,18,143,161,253,42,14,128,142,1306
42492492,Damian lillard,BA,32,58,58,2107,556,1202,0.463,244,658,0.371,312,544,0.574,0.564,510,558,0.914,44,233,277,425,50,18,191,109,1866
6012960,Shaedon sharpe,ES,19,80,15,1779,306,648,0.472,102,283,0.36,204,365,0.559,0.551,75,105,0.714,63,173,236,94,38,24,83,136,789
1836090,Drew eubanks,P,25,78,28,1584,214,334,0.641,7,18,0.389,207,316,0.655,0.651,83,125,0.664,132,286,418,103,40,102,67,169,518
15625000,Jusuf nurkic,P,28,52,52,1391,262,505,0.519,43,119,0.361,219,386,0.567,0.561,127,192,0.661,114,357,471,149,43,44,119,185,694
1563518,Trendon watford,AP,22,62,12,1182,181,323,0.56,25,64,0.391,156,259,0.602,0.599,72,100,0.72,42,196,238,130,32,12,71,118,459
4171548,Nassir little,AL,22,54,4,976,134,303,0.442,58,158,0.367,76,145,0.524,0.538,33,46,0.717,27,114,141,50,20,20,36,66,359
4097561,Justise winslow,AP,26,29,11,776,81,198,0.409,14,45,0.311,67,153,0.438,0.444,20,28,0.714,49,96,145,98,30,11,43,89,196
1017781,Jabari walker,AL,20,56,0,619,83,198,0.419,16,56,0.286,67,142,0.472,0.46,34,45,0.756,48,83,131,34,10,13,29,69,216
2681040,Keon johnson,ES,20,40,0,416,67,178,0.376,28,81,0.346,39,97,0.402,0.455,27,41,0.659,11,33,44,59,19,6,43,43,189
10552,Skylar mays,BA,25,6,6,189,34,68,0.5,12,26,0.462,22,42,0.524,0.588,12,13,0.923,2,17,19,50,6,1,10,11,92
52644,Jeenathan williams,ES,23,5,4,127,24,39,0.615,3,8,0.375,21,31,0.677,0.654,2,3,0.667,10,5,15,10,3,2,4,13,53
105522,Shaquille harrison,ES,29,5,0,120,15,36,0.417,3,10,0.3,12,26,0.462,0.458,11,15,0.733,1,21,22,30,11,2,6,12,44
35096,Justin minaya,AL,23,4,0,89,7,23,0.304,3,12,0.25,4,11,0.364,0.37,0,1,0.0,3,12,15,4,2,5,4,9,17
9441840,Jalen green,ES,20,76,76,2602,566,1359,0.416,187,554,0.338,379,805,0.471,0.485,364,463,0.786,43,241,284,281,59,18,200,131,1683
3375360,Alperen sengun,P,20,75,72,2171,442,799,0.553,19,57,0.333,423,742,0.57,0.565,206,288,0.715,242,436,678,291,70,70,193,258,1109
3359160,Tari eason,AP,21,82,5,1767,296,660,0.448,59,172,0.343,237,488,0.486,0.493,109,145,0.752,195,301,496,88,96,47,101,189,760
2471160,Usman garuba,P,20,75,1,970,86,177,0.486,24,59,0.407,62,118,0.525,0.554,29,47,0.617,120,187,307,64,44,29,47,135,225
1563518,Daishen nix,BA,20,57,7,914,81,237,0.342,40,140,0.286,41,97,0.423,0.426,24,36,0.667,18,80,98,132,31,7,86,59,226
2372160,Josh christopher,ES,21,64,2,786,153,329,0.465,21,89,0.236,132,240,0.55,0.497,45,60,0.75,20,51,71,73,33,15,60,59,372
7065217,Jae'sean tate,AL,27,31,7,677,110,229,0.48,13,46,0.283,97,183,0.53,0.509,50,69,0.725,41,77,118,84,21,7,47,106,283
601478,Boban marjanovic,P,34,31,0,171,41,60,0.683,0,1,0.0,41,59,0.695,0.683,20,27,0.741,20,40,60,9,5,2,14,10,102
3873025,Keldon johnson,AL,23,63,63,2063,503,1113,0.452,134,407,0.329,369,706,0.523,0.512,245,327,0.749,56,262,318,183,46,11,134,125,1385
1782621,Tre jones,BA,23,68,65,1984,341,743,0.459,45,158,0.285,296,585,0.506,0.489,148,172,0.86,56,189,245,448,89,9,110,98,875
2925600,Malaki branham,ES,19,66,32,1550,269,611,0.44,77,255,0.302,192,356,0.539,0.503,58,70,0.829,28,153,181,127,33,7,76,115,673
5063520,Jeremy sochan,AP,19,56,53,1458,250,552,0.453,33,134,0.246,217,418,0.519,0.483,81,116,0.698,95,200,295,142,43,23,97,138,614
1878720,Keita bates-diop,AP,27,67,42,1452,236,465,0.508,56,142,0.394,180,323,0.557,0.568,119,150,0.793,65,183,248,103,46,20,56,63,647
7350000,Zach collins,P,25,63,26,1441,284,548,0.518,55,147,0.374,229,401,0.571,0.568,108,142,0.761,116,286,402,180,37,49,129,199,731
13750000,Doug mcdermott,AL,31,64,0,1314,239,523,0.457,123,298,0.413,116,225,0.516,0.575,53,70,0.757,24,115,139,91,13,6,58,118,654
4437000,Devin vassell,ES,22,38,32,1178,261,595,0.439,103,266,0.387,158,329,0.48,0.525,78,100,0.78,8,140,148,136,43,17,57,57,703
5634257,Romeo langford,ES,23,43,21,844,121,259,0.467,16,61,0.262,105,198,0.53,0.498,39,56,0.696,57,57,114,50,24,13,30,67,297
2385480,Blake wesley,ES,19,37,1,669,69,215,0.321,20,52,0.385,49,163,0.301,0.367,26,44,0.591,11,70,81,99,25,5,65,67,184
74742,Charles bassey,P,22,35,2,508,87,135,0.644,3,8,0.375,84,127,0.661,0.656,22,37,0.595,75,118,193,47,16,33,41,74,199
1930681,Isaiah roby,AP,24,42,2,474,67,155,0.432,18,60,0.3,49,95,0.516,0.49,20,41,0.488,21,86,107,38,18,7,31,53,172
1245164,Stanley johnson,AL,26,30,0,469,65,122,0.533,18,40,0.45,47,82,0.573,0.607,26,39,0.667,22,73,95,67,16,6,33,48,174
105522,Gorgui dieng,P,33,31,1,358,45,117,0.385,21,75,0.28,24,42,0.571,0.474,10,13,0.769,27,80,107,53,4,14,32,57,121
4144320,Joshua primo,ES,20,4,0,93,9,26,0.346,3,12,0.25,6,14,0.429,0.404,7,9,0.778,2,11,13,18,1,2,11,8,28
192293,Alize johnson,AP,26,4,0,30,3,6,0.5,0,2,0.0,3,4,0.75,0.5,1,2,0.5,2,8,10,1,1,0,4,3,7
