Player,Pos,Age,Tm,G,GS,MP,FG,FGA,FG%,3P,3PA,3P%,2P,2PA,2P%,eFG%,FT,FTA,FT%,ORB,DRB,TRB,AST,STL,BLK,TOV,PF,PTS,Salario
Precious Achiuwa,P,24,TOT,56,17,1276,195,391,0.499,23,85,0.271,172,306,0.562,0.528,55,89,0.618,150,223,373,78,38,52,63,107,468,4379527
Bam Adebayo,P,26,MIA,53,53,1835,403,793,0.508,1,14,0.071,402,779,0.516,0.509,250,325,0.769,117,429,546,214,57,51,130,128,1057,32600060
Ochai Agbaji,ES,23,TOT,63,14,1208,132,323,0.409,56,177,0.316,76,146,0.521,0.495,24,32,0.75,46,109,155,57,32,33,44,83,344,4114200
Santi Aldama,AP,23,MEM,52,26,1334,210,485,0.433,89,255,0.349,121,230,0.526,0.525,42,69,0.609,62,228,290,115,34,41,63,75,551,2194200
Grayson Allen,ES,28,PHO,58,58,1949,250,505,0.495,154,328,0.47,96,177,0.542,0.648,100,113,0.885,36,191,227,179,50,37,75,127,754,8500000
Jarrett Allen,P,25,CLE,58,58,1836,381,608,0.627,0,5,0.0,381,603,0.632,0.627,178,243,0.733,198,426,624,159,44,67,97,120,940,20000000
Jose Alvarado,BA,25,NOP,42,0,723,106,258,0.411,52,148,0.351,54,110,0.491,0.512,29,42,0.69,16,75,91,86,48,14,33,62,293,1836096
Kyle Anderson,AP,30,MIN,62,6,1382,151,323,0.467,8,37,0.216,143,286,0.5,0.48,77,109,0.706,45,172,217,253,50,32,77,96,387,9219512
Cole Anthony,BA,23,ORL,63,0,1448,256,594,0.431,65,206,0.316,191,388,0.492,0.486,157,190,0.826,52,200,252,194,53,29,106,154,734,5539771
OG Anunoby,AL,26,TOT,41,41,1400,238,478,0.498,86,227,0.379,152,251,0.606,0.588,65,84,0.774,39,132,171,93,53,28,62,96,627,18642857
Ryan Arcidiacono,BA,29,NYK,20,0,45,0,6,0.0,0,6,0.0,0,0,,0.0,0,0,,0,8,8,4,2,0,2,5,0,2528233
Deni Avdija,AL,23,WAS,60,60,1723,306,606,0.505,70,175,0.4,236,431,0.548,0.563,143,193,0.741,68,342,410,223,48,26,121,150,825,6263188
Deandre Ayton,P,25,POR,41,41,1303,279,490,0.569,0,1,0.0,279,489,0.571,0.569,44,53,0.83,126,316,442,70,44,32,72,90,602,32459438
Marvin Bagley III,P,24,TOT,44,22,932,207,360,0.575,5,17,0.294,202,343,0.589,0.582,89,119,0.748,119,153,272,54,17,28,53,77,508,12500000
Patrick Baldwin Jr.,AL,21,WAS,20,0,152,18,47,0.383,11,27,0.407,7,20,0.35,0.5,8,12,0.667,7,36,43,8,2,4,6,22,55,2337720
LaMelo Ball,BA,22,CHO,22,22,711,183,423,0.433,70,197,0.355,113,226,0.5,0.515,90,104,0.865,29,84,113,176,40,4,83,79,526,10900635
Mo Bamba,P,25,PHI,41,4,457,62,132,0.47,14,34,0.412,48,98,0.49,0.523,21,33,0.636,57,100,157,28,13,40,30,64,159,2346614
Paolo Banchero,AP,21,ORL,62,62,2161,508,1099,0.462,94,257,0.366,414,842,0.492,0.505,310,439,0.706,69,356,425,322,61,36,192,123,1420,11608080
Desmond Bane,ES,25,MEM,37,37,1277,330,696,0.474,123,320,0.384,207,376,0.551,0.563,121,140,0.864,34,135,169,196,38,20,99,106,904,3845083
Dalano Banton,BA,24,TOT,36,5,449,80,193,0.415,21,67,0.313,59,126,0.468,0.469,43,61,0.705,28,61,89,50,11,9,27,38,224,2019706
Dominick Barlow,AP,20,SAS,26,1,350,49,97,0.505,3,8,0.375,46,89,0.517,0.521,27,40,0.675,38,55,93,30,11,13,5,40,128,877065
Harrison Barnes,AP,31,SAC,62,62,1815,263,537,0.49,115,291,0.395,148,246,0.602,0.597,115,142,0.81,49,126,175,70,43,10,43,78,756,17000000
Scottie Barnes,ES,22,TOR,60,60,2094,447,942,0.475,101,296,0.341,346,646,0.536,0.528,196,251,0.781,141,353,494,363,75,88,165,118,1191,8008560
RJ Barrett,ES,23,TOT,52,52,1637,375,768,0.488,85,230,0.37,290,538,0.539,0.544,175,249,0.703,44,228,272,162,28,20,103,113,1010,23883929
Charles Bassey,P,23,SAS,19,0,205,29,40,0.725,0,1,0.0,29,39,0.744,0.725,5,6,0.833,23,53,76,21,8,17,15,31,63,2500000
Keita Bates-Diop,AL,28,TOT,48,8,648,72,165,0.436,21,69,0.304,51,96,0.531,0.5,30,40,0.75,31,76,107,37,24,22,15,34,195,2346614
Nicolas Batum,AP,35,TOT,42,30,1022,82,171,0.48,51,121,0.421,31,50,0.62,0.629,14,19,0.737,52,114,166,90,29,30,26,84,229,11710818
Darius Bazley,AP,23,PHI,3,0,10,0,1,0.0,0,0,,0,1,0.0,0.0,0,0,,0,1,1,2,0,0,1,0,0,124425
Bradley Beal,ES,30,PHO,35,35,1141,251,506,0.496,59,155,0.381,192,351,0.547,0.554,84,107,0.785,30,113,143,161,33,10,87,90,645,46741590
Malik Beasley,ES,27,MIL,62,62,1836,253,553,0.458,179,411,0.436,74,142,0.521,0.619,17,27,0.63,39,200,239,88,53,7,43,129,702,2709849
MarJon Beauchamp,AL,23,MIL,45,1,589,74,155,0.477,28,71,0.394,46,84,0.548,0.568,19,28,0.679,22,74,96,30,12,6,27,52,195,2609400
Patrick Beverley,BA,35,TOT,59,6,1137,127,304,0.418,47,142,0.331,80,162,0.494,0.495,59,73,0.808,40,144,184,169,34,24,59,102,360,3196448
Saddiq Bey,AL,24,ATL,62,50,2035,287,686,0.418,110,350,0.314,177,336,0.527,0.499,165,197,0.838,166,240,406,90,51,11,54,87,849,4556983
Goga Bitadze,P,24,ORL,52,33,906,117,193,0.606,2,12,0.167,115,181,0.635,0.611,52,79,0.658,103,167,270,75,30,70,40,102,288,2066585
Onuralp Bitim,ES,24,CHI,8,0,96,9,24,0.375,8,18,0.444,1,6,0.167,0.542,3,4,0.75,2,10,12,3,2,1,3,6,29,895708
Bismack Biyombo,P,31,TOT,34,27,741,68,123,0.553,0,0,,68,123,0.553,0.553,22,46,0.478,59,136,195,52,10,35,39,87,158,1194075
Anthony Black,BA,20,ORL,58,33,1077,104,224,0.464,34,85,0.4,70,139,0.504,0.54,48,75,0.64,31,102,133,86,32,18,51,104,290,7245480
Bol Bol,AP,24,PHO,26,0,291,65,104,0.625,10,30,0.333,55,74,0.743,0.673,7,10,0.7,25,67,92,11,6,16,11,30,147,2165000
Marques Bolden,P,25,TOT,4,0,16,0,1,0.0,0,0,,0,1,0.0,0.0,0,0,,0,3,3,0,0,0,1,2,0,244502
Devin Booker,BA,27,PHO,50,50,1788,480,971,0.494,110,290,0.379,370,681,0.543,0.551,307,349,0.88,35,194,229,342,47,20,129,151,1377,36016200
Chris Boucher,AP,31,TOR,50,0,705,110,217,0.507,31,94,0.33,79,123,0.642,0.578,71,92,0.772,62,145,207,23,14,24,28,68,322,11750000
James Bouknight,ES,23,CHO,14,0,81,18,41,0.439,13,30,0.433,5,11,0.455,0.598,1,2,0.5,1,8,9,6,1,1,2,3,50,4570080
Jamaree Bouyea,BA,24,POR,6,0,57,5,21,0.238,0,8,0.0,5,13,0.385,0.238,0,0,,2,8,10,8,0,0,8,3,10,35389
Malaki Branham,BA,20,SAS,59,23,1228,211,480,0.44,70,196,0.357,141,284,0.496,0.513,45,48,0.938,21,97,118,132,23,6,70,74,537,3071880
Christian Braun,ES,22,DEN,64,1,1225,161,359,0.448,42,117,0.359,119,242,0.492,0.507,77,109,0.706,55,175,230,87,29,28,41,106,441,2949120
Mikal Bridges,AL,27,BRK,64,64,2265,470,1066,0.441,163,455,0.358,307,611,0.502,0.517,232,286,0.811,52,251,303,239,62,25,135,96,1335,21700000
Miles Bridges,AL,25,CHO,53,51,1985,435,943,0.461,126,349,0.361,309,594,0.52,0.528,135,161,0.839,52,348,400,174,55,27,107,98,1131,7921300
Oshae Brissett,AL,25,BOS,40,0,427,50,110,0.455,12,43,0.279,38,67,0.567,0.509,36,55,0.655,37,73,110,31,16,4,13,39,148,2165000
Izaiah Brockington,BA,24,NOP,1,0,3,2,5,0.4,0,1,0.0,2,4,0.5,0.4,0,0,,1,1,2,0,0,0,0,0,4,64343
Malcolm Brogdon,BA,31,POR,39,25,1121,218,496,0.44,82,199,0.412,136,297,0.458,0.522,95,116,0.819,28,120,148,214,27,8,60,58,613,22500000
Armoni Brooks,BA,25,BRK,10,0,104,15,46,0.326,11,32,0.344,4,14,0.286,0.446,1,2,0.5,7,11,18,5,1,1,3,3,42,241285
Dillon Brooks,AL,28,HOU,54,54,1692,251,579,0.434,102,270,0.378,149,309,0.482,0.522,97,117,0.829,43,149,192,90,49,7,67,181,701,22627671
Bruce Brown,ES,27,TOT,52,38,1463,212,458,0.463,42,138,0.304,170,320,0.531,0.509,95,110,0.864,43,188,231,142,48,16,59,118,561,21951220
Jaylen Brown,AL,27,BOS,58,58,1938,513,1024,0.501,119,336,0.354,394,688,0.573,0.559,179,254,0.705,67,255,322,215,63,29,136,154,1324,31830357
Kobe Brown,AP,24,LAC,34,0,285,24,63,0.381,12,39,0.308,12,24,0.5,0.476,1,2,0.5,10,35,45,17,6,3,7,41,61,2413320
Moses Brown,P,24,POR,13,4,114,15,31,0.484,0,0,,15,31,0.484,0.484,1,7,0.143,22,33,55,4,2,4,6,15,31,2165000
Jalen Brunson,BA,27,NYK,58,58,2048,561,1173,0.478,154,376,0.41,407,797,0.511,0.544,301,356,0.846,32,181,213,376,53,11,143,116,1577,26346666
Thomas Bryant,P,26,MIA,27,3,275,45,81,0.556,0,7,0.0,45,74,0.608,0.556,18,22,0.818,25,53,78,16,6,8,15,28,108,2528233
Kobe Bufkin,ES,20,ATL,9,0,89,13,37,0.351,5,17,0.294,8,20,0.4,0.419,2,4,0.5,2,12,14,15,3,1,5,6,33,4094280
Reggie Bullock,AL,32,HOU,26,0,226,21,52,0.404,16,41,0.39,5,11,0.455,0.558,1,1,1.0,3,32,35,10,4,2,6,15,59,3196448
Alec Burks,ES,32,TOT,54,1,1072,191,504,0.379,113,295,0.383,78,209,0.373,0.491,132,151,0.874,21,107,128,77,23,12,41,71,627,10489600
Jimmy Butler,AP,34,MIA,44,44,1501,302,597,0.506,45,102,0.441,257,495,0.519,0.544,306,359,0.852,86,159,245,216,62,15,78,49,955,45183960
Toumani Camara,AP,23,POR,60,40,1448,162,371,0.437,48,146,0.329,114,225,0.507,0.501,67,90,0.744,120,181,301,65,58,26,71,148,439,1119563
Clint Capela,P,29,ATL,55,55,1390,255,457,0.558,0,0,,255,457,0.558,0.558,101,151,0.669,254,314,568,59,29,82,50,133,611,22116000
Jevon Carter,BA,28,CHI,61,0,830,115,306,0.376,65,194,0.335,50,112,0.446,0.482,3,5,0.6,7,40,47,72,32,13,30,62,298,6190476
Wendell Carter Jr.,P,24,ORL,37,31,968,155,287,0.54,45,106,0.425,110,181,0.608,0.618,71,99,0.717,74,174,248,59,17,20,45,85,426,13050000
Alex Caruso,ES,29,CHI,55,42,1513,187,402,0.465,93,245,0.38,94,157,0.599,0.581,59,76,0.776,49,154,203,162,86,62,73,141,526,9460000
Malcolm Cazalon,ES,22,DET,1,0,3,0,0,,0,0,,0,0,,,0,0,,0,0,0,0,0,0,0,0,0,389274
Julian Champagnie,AL,22,SAS,56,41,954,106,268,0.396,70,192,0.365,36,76,0.474,0.526,48,58,0.828,34,113,147,71,32,30,36,56,330,3000000
Max Christie,ES,20,LAL,51,7,815,86,201,0.428,36,100,0.36,50,101,0.495,0.517,33,42,0.786,12,109,121,52,17,16,31,53,241,1719864
Sidy Cissoko,AL,19,SAS,6,0,32,1,6,0.167,0,4,0.0,1,2,0.5,0.167,4,4,1.0,0,6,6,0,3,0,1,2,6,1119563
Jordan Clarkson,ES,31,UTA,53,19,1616,327,791,0.413,90,303,0.297,237,488,0.486,0.47,173,196,0.883,49,135,184,267,34,6,140,77,917,23487629
Noah Clowney,AP,19,BRK,8,0,79,11,18,0.611,1,4,0.25,10,14,0.714,0.639,6,6,1.0,6,9,15,8,2,1,3,6,29,3089520
Amir Coffey,AL,26,LAC,50,9,936,105,204,0.515,40,99,0.404,65,105,0.619,0.613,45,51,0.882,18,67,85,45,28,7,21,65,295,3666667
John Collins,AP,26,UTA,60,58,1695,347,657,0.528,70,207,0.338,277,450,0.616,0.581,114,147,0.776,140,375,515,71,34,56,88,168,878,25340000
Zach Collins,P,26,SAS,52,26,1209,229,476,0.481,46,148,0.311,183,328,0.558,0.529,89,121,0.736,90,184,274,155,25,36,102,161,593,7700000
Mike Conley,BA,36,MIN,59,59,1706,209,476,0.439,129,303,0.426,80,173,0.462,0.575,72,79,0.911,27,147,174,364,62,12,70,96,619,24360000
Pat Connaughton,AL,31,MIL,58,2,1254,116,248,0.468,68,174,0.391,48,74,0.649,0.605,27,38,0.711,36,152,188,110,32,14,36,72,327,9423869
Bilal Coulibaly,AL,19,WAS,59,11,1582,173,394,0.439,57,164,0.348,116,230,0.504,0.511,82,117,0.701,51,185,236,99,50,45,82,128,485,6614280
Robert Covington,,33,TOT,29,6,488,43,98,0.439,19,56,0.339,24,42,0.571,0.536,22,26,0.846,31,66,97,24,39,18,11,56,127,11692308
Torrey Craig,AL,33,CHI,35,8,721,73,174,0.42,39,105,0.371,34,69,0.493,0.532,21,27,0.778,57,103,160,38,21,16,22,78,206,2528233
Jae Crowder,AP,33,MIL,33,17,804,74,177,0.418,38,111,0.342,36,66,0.545,0.525,18,26,0.692,18,102,120,48,28,6,16,56,204,3196448
Jalen Crutcher,BA,24,NOP,1,0,3,0,1,0.0,0,0,,0,1,0.0,0.0,0,0,,0,0,0,0,0,0,0,0,0,64343
Cade Cunningham,BA,22,DET,53,53,1793,443,976,0.454,105,287,0.366,338,689,0.491,0.508,206,238,0.866,27,197,224,399,45,20,186,137,1197,11055240
Seth Curry,ES,33,TOT,44,4,616,80,204,0.392,38,108,0.352,42,96,0.438,0.485,28,31,0.903,18,50,68,44,22,6,21,39,226,4000000
Stephen Curry,BA,35,GSW,59,59,1936,523,1164,0.449,290,713,0.407,233,451,0.517,0.574,254,276,0.92,30,227,257,291,46,21,176,100,1590,51915615
Dyson Daniels,BA,20,NOP,52,15,1139,112,256,0.438,32,110,0.291,80,146,0.548,0.5,32,50,0.64,51,140,191,136,72,21,52,84,288,5784120
Anthony Davis,P,30,LAL,61,61,2183,576,1038,0.555,19,74,0.257,557,964,0.578,0.564,337,413,0.816,182,566,748,221,66,149,121,146,1508,40600080
Johnny Davis,ES,21,WAS,32,0,316,31,90,0.344,5,18,0.278,26,72,0.361,0.372,6,11,0.545,14,29,43,13,10,3,8,27,73,5050800
Dexter Dennis,ES,24,DAL,4,0,30,10,19,0.526,1,8,0.125,9,11,0.818,0.553,1,3,0.333,1,8,9,4,0,1,3,1,22,212331
DeMar DeRozan,AL,34,CHI,62,62,2350,488,1034,0.472,61,178,0.343,427,856,0.499,0.501,399,462,0.864,37,228,265,333,66,36,91,134,1436,28600000
Mamadi Diakite,AP,27,SAS,3,0,16,4,5,0.8,0,0,,4,5,0.8,0.8,4,6,0.667,1,2,3,2,0,1,0,1,12,199463
Hamidou Diallo,ES,25,WAS,2,0,5,1,2,0.5,0,0,,1,2,0.5,0.5,0,0,,2,0,2,1,2,0,1,1,2,134863
Gradey Dick,ES,20,TOR,43,2,747,102,240,0.425,54,146,0.37,48,94,0.511,0.538,23,25,0.92,21,64,85,47,22,0,26,60,281,4536720
Ousmane Dieng,AP,20,OKC,29,0,326,43,101,0.426,20,64,0.313,23,37,0.622,0.525,14,16,0.875,10,39,49,31,5,3,16,19,120,4798440
Spencer Dinwiddie,BA,30,TOT,59,49,1747,215,553,0.389,100,312,0.321,115,241,0.477,0.479,133,171,0.778,27,143,170,324,43,13,73,106,663,1554664
Donte DiVincenzo,ES,27,NYK,62,44,1638,314,711,0.442,200,495,0.404,114,216,0.528,0.582,57,78,0.731,49,163,212,160,77,24,83,121,885,10900000
Luka Dončić,BA,24,DAL,56,56,2104,662,1332,0.497,220,579,0.38,442,753,0.587,0.58,399,506,0.789,42,463,505,548,82,33,222,117,1943,40064220
Luguentz Dort,AL,24,OKC,61,61,1739,222,505,0.44,121,301,0.402,101,204,0.495,0.559,86,105,0.819,63,167,230,80,55,42,53,183,651,15277778
Ayo Dosunmu,ES,24,CHI,62,23,1701,261,532,0.491,92,230,0.4,169,302,0.56,0.577,57,73,0.781,42,125,167,178,53,29,75,129,671,6481481
Andre Drummond,P,30,CHI,64,10,1097,215,391,0.55,0,3,0.0,215,388,0.554,0.55,96,170,0.565,217,347,564,30,61,41,70,115,526,3360000
Chris Duarte,AL,26,SAC,43,11,569,60,156,0.385,32,90,0.356,28,66,0.424,0.487,21,27,0.778,19,64,83,35,23,5,20,67,173,4124280
Kris Dunn,BA,29,UTA,56,28,1029,124,256,0.484,35,90,0.389,89,166,0.536,0.553,17,25,0.68,41,115,156,220,59,23,71,109,300,2586484
Kevin Durant,AP,35,PHO,57,57,2123,586,1108,0.529,126,298,0.423,460,810,0.568,0.586,317,371,0.854,32,349,381,311,50,73,191,103,1615,47649433
Jalen Duren,P,20,DET,48,47,1431,280,448,0.625,0,3,0.0,280,445,0.629,0.625,98,126,0.778,156,407,563,126,23,40,96,161,658,4330680
Tari Eason,AP,22,HOU,22,0,480,88,189,0.466,18,50,0.36,70,139,0.504,0.513,21,33,0.636,46,107,153,27,31,19,20,51,215,3527160
Anthony Edwards,ES,22,MIN,61,60,2138,558,1208,0.462,152,408,0.373,406,800,0.508,0.525,336,400,0.84,34,284,318,306,77,33,191,114,1604,13534817
Kessler Edwards,AL,23,SAC,39,0,189,21,53,0.396,12,33,0.364,9,20,0.45,0.509,4,6,0.667,5,25,30,9,4,4,1,18,58,1927896
Keon Ellis,ES,24,SAC,37,4,437,45,104,0.433,31,82,0.378,14,22,0.636,0.582,11,17,0.647,16,35,51,46,21,14,19,52,132,1450668
Joel Embiid,P,29,PHI,34,34,1157,402,754,0.533,41,112,0.366,361,642,0.562,0.56,356,403,0.883,89,295,384,193,39,60,126,98,1201,47607350
Drew Eubanks,P,26,PHO,58,4,922,126,202,0.624,3,3,1.0,123,199,0.618,0.631,61,80,0.763,78,169,247,51,22,49,53,90,316,2346614
Tosan Evbuomwan,AL,22,TOT,6,0,90,7,18,0.389,3,9,0.333,4,9,0.444,0.472,0,0,,8,8,16,6,1,1,1,6,17,64343
Dante Exum,BA,28,DAL,38,14,722,123,219,0.562,34,70,0.486,89,149,0.597,0.639,43,57,0.754,19,83,102,109,19,5,29,60,323,3000000
Bruno Fernando,P,25,ATL,26,1,315,48,87,0.552,0,3,0.0,48,84,0.571,0.552,27,44,0.614,31,64,95,16,12,16,19,46,123,2581522
Dorian Finney-Smith,AP,30,BRK,55,44,1560,181,425,0.426,106,284,0.373,75,141,0.532,0.551,22,32,0.688,93,167,260,85,42,32,50,125,490,13394160
Malachi Flynn,BA,25,TOT,54,0,607,77,193,0.399,36,106,0.34,41,87,0.471,0.492,28,37,0.757,13,67,80,89,22,6,42,51,218,3873025
Simone Fontecchio,AL,28,TOT,62,39,1500,228,498,0.458,122,305,0.4,106,193,0.549,0.58,48,59,0.814,61,159,220,96,41,20,61,100,626,3044872
Trent Forrest,ES,25,ATL,25,0,250,21,56,0.375,2,7,0.286,19,49,0.388,0.393,9,12,0.75,6,25,31,49,7,1,11,21,53,968162
Evan Fournier,ES,31,TOT,14,0,230,32,89,0.36,17,58,0.293,15,31,0.484,0.455,13,15,0.867,3,25,28,16,13,2,10,21,94,18857143
De'Aaron Fox,BA,26,SAC,54,54,1931,539,1137,0.474,149,410,0.363,390,727,0.536,0.54,242,339,0.714,50,176,226,305,104,21,145,141,1469,32600060
Alex Fudge,AL,20,LAL,4,0,14,1,6,0.167,0,2,0.0,1,4,0.25,0.167,2,2,1.0,2,0,2,0,0,0,1,1,4,241285
Markelle Fultz,BA,25,ORL,27,15,603,103,210,0.49,1,10,0.1,102,200,0.51,0.493,15,25,0.6,36,54,90,84,30,9,32,40,222,17000000
Daniel Gafford,AP,25,TOT,57,49,1410,253,362,0.699,0,0,,253,362,0.699,0.699,103,148,0.696,159,287,446,78,51,116,56,176,609,12402000
Danilo Gallinari,AP,35,TOT,40,0,551,73,170,0.429,27,84,0.321,46,86,0.535,0.509,74,86,0.86,18,80,98,50,10,5,17,43,247,1047112
Darius Garland,BA,24,CLE,39,39,1295,262,579,0.453,85,233,0.365,177,346,0.512,0.526,118,140,0.843,19,74,93,245,51,4,125,64,727,34005250
Usman Garuba,AP,21,GSW,3,0,8,0,1,0.0,0,0,,0,1,0.0,0.0,0,0,,1,0,1,1,1,0,0,2,0,2588400
Kaiser Gates,AL,27,NOP,1,0,7,0,4,0.0,0,2,0.0,0,2,0.0,0.0,0,0,,0,1,1,0,0,0,0,0,0,35389
Keyonte George,BA,20,UTA,57,26,1459,228,572,0.399,114,317,0.36,114,255,0.447,0.498,129,157,0.822,14,147,161,252,27,5,121,63,699,3889800
Paul George,AP,33,LAC,57,57,1938,443,968,0.458,186,470,0.396,257,498,0.516,0.554,188,213,0.883,30,275,305,206,89,25,117,161,1260,45640165
Josh Giddey,ES,21,OKC,62,62,1531,286,626,0.457,59,179,0.33,227,447,0.508,0.504,71,86,0.826,82,293,375,274,42,34,125,80,702,6587160
Harry Giles,P,25,TOT,18,0,85,22,45,0.489,3,12,0.25,19,33,0.576,0.522,7,13,0.538,12,15,27,6,1,3,6,15,54,2092354
Anthony Gill,AP,31,WAS,33,0,175,24,51,0.471,3,13,0.231,21,38,0.553,0.5,15,20,0.75,14,25,39,14,7,6,15,12,66,1997238
Jacob Gilyard,BA,25,MEM,37,14,654,60,144,0.417,51,120,0.425,9,24,0.375,0.594,2,2,1.0,8,35,43,131,27,5,29,35,173,398925
Rudy Gobert,P,31,MIN,62,62,2104,325,501,0.649,0,3,0.0,325,498,0.653,0.649,203,313,0.649,227,573,800,75,38,133,96,193,853,41000000
Jordan Goodwin,BA,25,TOT,46,5,730,93,248,0.375,28,98,0.286,65,150,0.433,0.431,29,39,0.744,50,93,143,106,33,16,39,52,243,1927986
Aaron Gordon,AP,28,DEN,58,58,1822,318,575,0.553,31,108,0.287,287,467,0.615,0.58,133,204,0.652,137,238,375,188,50,37,85,111,800,21266182
Eric Gordon,ES,35,PHO,53,24,1564,232,520,0.446,125,329,0.38,107,191,0.56,0.566,46,58,0.793,15,93,108,117,50,25,64,63,635,3196448
Devonte' Graham,BA,28,SAS,13,0,111,14,34,0.412,9,24,0.375,5,10,0.5,0.544,6,8,0.75,2,16,18,19,4,1,3,6,43,12100000
Jerami Grant,AP,29,POR,53,53,1795,378,836,0.452,110,272,0.404,268,564,0.475,0.518,252,309,0.816,37,152,189,150,43,34,114,117,1118,27586207
A.J. Green,ES,24,MIL,42,0,401,61,141,0.433,50,122,0.41,11,19,0.579,0.61,10,11,0.909,6,39,45,26,3,2,7,36,182,1801769
Danny Green,ES,36,PHI,2,0,18,0,2,0.0,0,1,0.0,0,1,0.0,0.0,0,0,,0,2,2,1,1,0,0,1,0,500000
Draymond Green,AP,33,GSW,39,36,1033,135,270,0.5,41,95,0.432,94,175,0.537,0.576,45,59,0.763,50,224,274,232,30,37,95,118,356,22321429
Jalen Green,ES,21,HOU,63,63,1939,404,979,0.413,136,431,0.316,268,548,0.489,0.482,212,262,0.809,27,276,303,211,48,20,139,83,1156,9891600
Jeff Green,AP,37,HOU,59,5,966,113,242,0.467,27,88,0.307,86,154,0.558,0.523,98,121,0.81,34,91,125,51,10,26,40,82,351,9600000
Josh Green,ES,23,DAL,51,32,1385,167,344,0.485,69,172,0.401,98,172,0.57,0.586,37,55,0.673,36,130,166,122,45,9,55,101,440,4765339
Quentin Grimes,ES,23,TOT,49,18,989,120,314,0.382,81,231,0.351,39,83,0.47,0.511,27,37,0.73,14,82,96,60,34,7,26,70,348,2385720
Mouhamadou Gueye,AP,25,TOR,2,0,10,1,4,0.25,0,0,,1,4,0.25,0.25,0,0,,3,2,5,0,0,3,0,2,2,64343
Mouhamed Gueye,AP,21,ATL,2,0,4,0,1,0.0,0,1,0.0,0,0,,0.0,0,0,,0,0,0,0,1,0,0,1,0,1119563
Rui Hachimura,AP,25,LAL,51,22,1302,250,483,0.518,67,165,0.406,183,318,0.575,0.587,70,99,0.707,39,152,191,53,36,16,36,74,637,15740741
Tyrese Haliburton,BA,23,IND,51,50,1635,383,793,0.483,150,398,0.377,233,395,0.59,0.578,145,171,0.848,30,164,194,580,54,33,119,48,1061,5808435
R.J. Hampton,BA,22,MIA,8,2,76,4,14,0.286,1,8,0.125,3,6,0.5,0.321,1,2,0.5,2,4,6,8,0,0,3,8,10,120250
Tim Hardaway Jr.,AL,31,DAL,61,10,1737,338,830,0.407,182,504,0.361,156,326,0.479,0.517,130,152,0.855,19,190,209,101,29,5,57,90,988,17897728
James Harden,BA,34,LAC,57,57,1974,293,657,0.446,160,392,0.408,133,265,0.502,0.568,257,292,0.88,25,270,295,473,62,52,146,109,1003,35640000
Jaden Hardy,ES,21,DAL,56,6,807,159,392,0.406,70,192,0.365,89,200,0.445,0.495,44,59,0.746,15,87,102,87,17,4,41,58,432,1719864
Ron Harper Jr.,AP,23,TOR,1,0,4,0,0,,0,0,,0,0,,,0,0,,0,0,0,1,0,0,0,2,0,147988
Gary Harris,ES,29,ORL,40,13,918,101,221,0.457,57,150,0.38,44,71,0.62,0.586,28,37,0.757,18,48,66,69,37,11,21,68,287,13000000
Joe Harris,ES,32,DET,16,0,170,14,39,0.359,10,30,0.333,4,9,0.444,0.487,1,2,0.5,3,10,13,10,3,2,4,19,39,19928571
Tobias Harris,AP,31,PHI,57,57,1937,385,777,0.495,70,203,0.345,315,574,0.549,0.541,160,179,0.894,64,290,354,183,59,32,76,96,1000,39270150
Shaquille Harrison,ES,30,MEM,3,0,6,1,2,0.5,0,0,,1,2,0.5,0.5,0,0,,0,2,2,0,0,1,0,0,2,145301
Josh Hart,AL,28,NYK,62,23,1959,212,493,0.43,69,206,0.335,143,287,0.498,0.5,61,80,0.763,88,384,472,221,52,20,84,120,554,12960000
Isaiah Hartenstein,P,25,NYK,57,31,1425,156,258,0.605,1,3,0.333,155,255,0.608,0.607,80,110,0.727,188,288,476,123,62,63,67,159,393,8195121
Sam Hauser,AL,26,BOS,62,6,1286,166,373,0.445,134,322,0.416,32,51,0.627,0.625,15,17,0.882,36,170,206,56,23,18,28,80,481,1927896
Jordan Hawkins,ES,21,NOP,55,10,1075,167,428,0.39,104,281,0.37,63,147,0.429,0.512,64,75,0.853,28,113,141,65,17,6,38,68,502,4310160
Jaxson Hayes,P,23,LAL,54,3,617,85,123,0.691,0,8,0.0,85,115,0.739,0.691,33,55,0.6,46,91,137,24,26,22,26,89,203,2165000
Killian Hayes,BA,22,DET,42,31,1008,117,283,0.413,22,74,0.297,95,209,0.455,0.452,33,50,0.66,11,108,119,205,36,20,51,75,289,7413955
Gordon Hayward,AL,33,TOT,34,25,936,150,331,0.453,24,65,0.369,126,266,0.474,0.489,68,89,0.764,31,113,144,127,31,12,54,52,392,31500000
Scoot Henderson,BA,19,POR,44,16,1186,195,518,0.376,53,172,0.308,142,346,0.41,0.428,123,150,0.82,38,90,128,207,25,10,128,133,566,9770880
Taylor Hendricks,AP,20,UTA,23,6,401,51,116,0.44,23,68,0.338,28,48,0.583,0.539,9,11,0.818,27,64,91,13,14,13,17,40,134,5569920
Tyler Herro,ES,24,MIA,36,36,1209,283,648,0.437,117,293,0.399,166,355,0.468,0.527,66,79,0.835,18,173,191,158,29,3,77,51,749,27000000
Buddy Hield,ES,31,TOT,65,41,1757,299,685,0.436,180,463,0.389,119,222,0.536,0.568,38,44,0.864,41,169,210,203,60,35,84,139,816,19279841
Haywood Highsmith,AP,27,MIA,47,24,945,97,226,0.429,49,135,0.363,48,91,0.527,0.538,21,26,0.808,39,90,129,46,42,25,26,89,264,1902137
D'Moi Hodge,ES,25,LAL,7,0,41,5,15,0.333,3,12,0.25,2,3,0.667,0.433,1,2,0.5,0,0,0,5,1,1,1,4,14,241285
Aaron Holiday,BA,27,HOU,60,1,1001,146,323,0.452,70,172,0.407,76,151,0.503,0.56,40,45,0.889,16,84,100,108,32,5,45,94,402,2346614
Jrue Holiday,BA,33,BOS,58,58,1924,285,588,0.485,119,267,0.446,166,321,0.517,0.586,58,70,0.829,74,249,323,279,51,42,108,95,747,36158747
Justin Holiday,ES,34,DEN,40,9,587,58,124,0.468,36,88,0.409,22,36,0.611,0.613,3,4,0.75,6,43,49,46,24,5,9,49,155,3196448
Richaun Holmes,AP,30,TOT,33,3,383,57,99,0.576,1,1,1.0,56,98,0.571,0.581,22,32,0.688,47,70,117,19,8,13,16,52,137,12046020
Chet Holmgren,P,21,OKC,63,63,1902,402,744,0.54,106,271,0.391,296,473,0.626,0.612,162,206,0.786,101,389,490,172,41,157,101,154,1072,10386000
Jalen Hood-Schifino,ES,20,LAL,21,0,109,10,45,0.222,2,15,0.133,8,30,0.267,0.244,12,20,0.6,2,11,13,8,3,2,9,13,34,3695040
Al Horford,P,37,BOS,53,24,1413,158,326,0.485,79,202,0.391,79,124,0.637,0.606,19,22,0.864,68,284,352,140,29,51,37,80,414,10000000
Talen Horton-Tucker,BA,23,UTA,41,11,805,146,364,0.401,46,139,0.331,100,225,0.444,0.464,72,90,0.8,20,83,103,153,36,15,55,75,410,11020000
Caleb Houstan,AL,21,ORL,47,9,674,68,172,0.395,61,161,0.379,7,11,0.636,0.573,19,24,0.792,23,51,74,26,12,3,15,52,216,2000000
Jett Howard,AL,20,ORL,13,0,49,8,22,0.364,5,17,0.294,3,5,0.6,0.477,2,4,0.5,1,4,5,3,0,1,2,3,23,5026800
Kevin Huerter,ES,25,SAC,60,55,1494,241,540,0.446,120,328,0.366,121,212,0.571,0.557,36,47,0.766,38,176,214,157,39,22,50,126,638,15669643
De'Andre Hunter,AL,26,ATL,39,24,1097,201,418,0.481,78,183,0.426,123,235,0.523,0.574,120,140,0.857,22,124,146,50,30,12,53,107,600,20089286
Bones Hyland,BA,23,LAC,24,2,316,53,143,0.371,24,75,0.32,29,68,0.426,0.455,11,14,0.786,3,18,21,45,13,2,27,31,141,2306400
Joe Ingles,AL,36,ORL,50,0,862,74,180,0.411,50,123,0.407,24,57,0.421,0.55,19,23,0.826,17,90,107,148,33,4,45,69,217,11000000
Brandon Ingram,AL,26,NOP,57,57,1892,458,928,0.494,81,222,0.365,377,706,0.534,0.537,235,292,0.805,40,247,287,330,45,35,151,131,1232,33833400
Kyrie Irving,ES,31,DAL,42,42,1439,407,831,0.49,126,301,0.419,281,530,0.53,0.566,131,146,0.897,32,180,212,210,50,19,71,77,1071,37037037
Jonathan Isaac,AP,26,ORL,43,1,636,100,202,0.495,22,70,0.314,78,132,0.591,0.55,48,67,0.716,54,129,183,19,31,49,22,44,270,17400000
Jaden Ivey,ES,21,DET,59,43,1668,317,718,0.442,92,269,0.342,225,449,0.501,0.506,183,243,0.753,75,133,208,214,43,34,144,168,909,7614480
Andre Jackson Jr.,ES,22,MIL,48,8,504,46,88,0.523,15,40,0.375,31,48,0.646,0.608,8,11,0.727,36,58,94,44,14,4,22,82,115,1119563
Isaiah Jackson,P,22,IND,47,3,637,132,199,0.663,0,4,0.0,132,195,0.677,0.663,63,88,0.716,72,121,193,40,29,51,35,118,327,2696280
Jaren Jackson Jr.,P,24,MEM,56,56,1795,435,979,0.444,102,317,0.322,333,662,0.503,0.496,291,358,0.813,70,247,317,120,63,89,133,198,1263,27102202
Justin Jackson,AL,28,MIN,2,0,1,0,0,,0,0,,0,0,,,0,0,,0,0,0,0,0,0,0,0,0,145301
Reggie Jackson,BA,33,DEN,64,16,1427,258,584,0.442,77,218,0.353,181,366,0.495,0.508,52,67,0.776,23,103,126,241,34,10,80,113,645,5000000
Trayce Jackson-Davis,AP,23,GSW,50,4,674,146,206,0.709,0,0,,146,206,0.709,0.709,52,93,0.559,82,123,205,46,16,46,32,84,344,1119563
LeBron James,AP,39,LAL,56,56,1962,535,1013,0.528,122,301,0.405,413,712,0.58,0.588,223,301,0.741,47,348,395,448,71,33,180,65,1415,47607350
Jaime Jaquez Jr.,AL,22,MIA,57,17,1679,284,568,0.5,53,160,0.331,231,408,0.566,0.547,114,141,0.809,70,157,227,147,64,11,90,131,735,3510600
DaQuan Jeffries,ES,26,NYK,13,0,34,5,14,0.357,1,7,0.143,4,7,0.571,0.393,0,2,0.0,0,5,5,2,0,0,1,2,11,951635
Trey Jemison,P,24,TOT,12,5,206,26,48,0.542,0,0,,26,48,0.542,0.542,8,11,0.727,18,28,46,8,5,11,12,36,60,64343
Ty Jerome,ES,26,CLE,2,0,15,2,4,0.5,0,1,0.0,2,3,0.667,0.5,0,0,,1,0,1,3,0,0,1,2,4,2439025
Isaiah Joe,ES,24,OKC,59,0,1087,168,364,0.462,111,267,0.416,57,97,0.588,0.614,34,40,0.85,24,111,135,66,35,17,36,67,481,1997238
Cameron Johnson,AP,27,BRK,49,45,1359,243,537,0.453,120,303,0.396,123,234,0.526,0.564,68,88,0.773,50,166,216,122,41,13,48,92,674,25700000
Jalen Johnson,AL,22,ATL,48,45,1630,304,582,0.522,56,162,0.346,248,420,0.59,0.57,88,121,0.727,63,351,414,165,55,43,83,122,752,2925480
James Johnson,AP,36,IND,6,0,32,2,6,0.333,0,1,0.0,2,5,0.4,0.333,2,2,1.0,1,3,4,6,4,1,2,7,6,2608596
Keldon Johnson,AL,24,SAS,60,26,1777,351,776,0.452,111,321,0.346,240,455,0.527,0.524,148,189,0.783,83,246,329,178,47,18,90,133,961,20000000
Keon Johnson,ES,21,BRK,4,0,51,7,19,0.368,4,9,0.444,3,10,0.3,0.474,10,10,1.0,3,2,5,3,3,1,4,4,28,2808720
Nikola Jokić,P,28,DEN,62,62,2120,634,1088,0.583,64,183,0.35,570,905,0.63,0.612,282,342,0.825,178,578,756,568,75,57,182,156,1614,47607350
Colby Jones,ES,21,SAC,17,0,121,17,46,0.37,1,13,0.077,16,33,0.485,0.38,2,5,0.4,10,15,25,10,4,1,5,16,37,2019706
Damian Jones,P,28,CLE,27,0,167,18,35,0.514,2,7,0.286,16,28,0.571,0.543,10,11,0.909,10,27,37,12,3,11,10,18,48,2586665
Derrick Jones Jr.,AL,26,DAL,59,49,1397,192,391,0.491,68,194,0.351,124,197,0.629,0.578,75,104,0.721,63,141,204,57,45,40,52,96,527,2709849
Herbert Jones,AL,25,NOP,58,58,1702,234,456,0.513,90,207,0.435,144,249,0.578,0.612,99,116,0.853,62,147,209,143,74,45,68,168,657,12015150
Tre Jones,BA,24,SAS,59,30,1555,217,431,0.503,41,133,0.308,176,298,0.591,0.551,82,94,0.872,40,157,197,356,56,7,85,69,557,9895833
Tyus Jones,BA,27,WAS,63,63,1829,315,637,0.495,101,241,0.419,214,396,0.54,0.574,30,38,0.789,20,154,174,452,69,18,62,47,761,14000000
DeAndre Jordan,P,35,DEN,29,1,327,48,76,0.632,0,0,,48,76,0.632,0.632,22,49,0.449,48,84,132,20,5,13,19,48,118,3196448
Cory Joseph,BA,32,GSW,26,0,296,23,64,0.359,13,42,0.31,10,22,0.455,0.461,4,7,0.571,6,24,30,42,4,3,12,25,63,3196448
Luke Kennard,ES,27,MEM,32,15,799,115,250,0.46,88,191,0.461,27,59,0.458,0.636,38,43,0.884,9,80,89,97,15,1,37,34,356,15418363
Walker Kessler,P,22,UTA,52,18,1213,194,302,0.642,4,19,0.211,190,283,0.671,0.649,46,81,0.568,137,253,390,46,26,139,53,110,438,2831160
Corey Kispert,AL,24,WAS,61,3,1390,266,558,0.477,123,341,0.361,143,217,0.659,0.587,88,113,0.779,19,136,155,105,26,11,70,99,743,3722040
Maxi Kleber,P,32,DAL,27,7,589,44,106,0.415,21,65,0.323,23,41,0.561,0.514,19,29,0.655,18,79,97,43,9,19,20,54,128,11000000
Kevin Knox,AL,24,DET,31,11,560,86,186,0.462,31,94,0.33,55,92,0.598,0.546,20,22,0.909,18,57,75,23,13,7,22,50,223,2144320
John Konchar,AL,27,MEM,49,18,981,75,177,0.424,31,101,0.307,44,76,0.579,0.511,17,20,0.85,60,154,214,90,41,47,36,64,198,2400000
Furkan Korkmaz,ES,26,PHI,35,0,300,30,76,0.395,14,40,0.35,16,36,0.444,0.487,14,20,0.7,4,26,30,25,14,3,10,17,88,5370370
Luke Kornet,P,28,BOS,45,2,662,97,139,0.698,0,0,,97,139,0.698,0.698,33,37,0.892,81,93,174,37,16,44,17,63,227,2413304
Jonathan Kuminga,AP,21,GSW,62,36,1601,375,706,0.531,42,140,0.3,333,566,0.588,0.561,191,259,0.737,82,216,298,129,43,30,99,135,983,6012720
Kyle Kuzma,AP,28,WAS,61,61,1957,534,1155,0.462,140,414,0.338,394,741,0.532,0.523,155,199,0.779,59,340,399,254,31,44,158,132,1363,25568182
Jock Landale,P,28,HOU,37,0,335,33,86,0.384,3,20,0.15,30,66,0.455,0.401,19,24,0.792,49,39,88,25,9,14,12,36,88,8000000
Jake LaRavia,AP,22,MEM,19,0,312,43,118,0.364,14,58,0.241,29,60,0.483,0.424,32,40,0.8,24,36,60,20,10,7,15,35,132,3199920
Zach LaVine,ES,28,CHI,25,23,872,170,376,0.452,59,169,0.349,111,207,0.536,0.531,88,103,0.854,8,121,129,98,21,8,52,57,487,40064220
Alex Len,P,30,SAC,28,0,247,31,54,0.574,0,3,0.0,31,51,0.608,0.574,7,17,0.412,33,50,83,25,8,15,18,32,69,3196448
Kawhi Leonard,AL,32,LAC,57,57,1972,515,985,0.523,123,289,0.426,392,696,0.563,0.585,215,241,0.892,70,285,355,214,98,48,96,85,1368,45640084
Caris LeVert,ES,29,CLE,51,1,1429,260,630,0.413,85,258,0.329,175,372,0.47,0.48,108,144,0.75,27,170,197,245,50,24,79,89,713,15384616
Kira Lewis Jr.,BA,22,TOT,19,0,153,17,54,0.315,2,21,0.095,15,33,0.455,0.333,10,11,0.909,5,10,15,21,6,1,8,9,46,5722116
Maxwell Lewis,AL,21,LAL,22,0,74,3,12,0.25,1,3,0.333,2,9,0.222,0.292,0,0,,1,2,3,3,2,0,7,4,7,1119563
E.J. Liddell,AP,23,NOP,8,0,23,1,6,0.167,0,5,0.0,1,1,1.0,0.167,2,2,1.0,0,5,5,1,2,2,2,2,4,1801769
Damian Lillard,BA,33,MIL,59,59,2062,437,1032,0.423,177,506,0.35,260,526,0.494,0.509,395,426,0.927,30,225,255,400,61,12,152,105,1446,45640084
Nassir Little,AL,23,PHO,34,2,426,49,107,0.458,19,60,0.317,30,47,0.638,0.547,17,20,0.85,14,57,71,19,10,10,13,37,134,6250000
Dereck Lively II,P,19,DAL,45,42,1108,176,237,0.743,0,2,0.0,176,235,0.749,0.743,37,70,0.529,119,197,316,52,31,65,44,129,389,4775640
Isaiah Livers,AP,25,DET,23,6,469,40,116,0.345,22,77,0.286,18,39,0.462,0.44,12,18,0.667,15,33,48,25,13,5,16,43,114,1836096
Chris Livingston,AL,20,MIL,16,0,69,7,16,0.438,1,3,0.333,6,13,0.462,0.469,2,2,1.0,2,13,15,5,2,0,4,11,17,1119563
Kevon Looney,P,27,GSW,61,36,1033,116,195,0.595,0,1,0.0,116,194,0.598,0.595,46,68,0.676,125,236,361,123,24,22,44,132,278,7500000
Brook Lopez,P,35,MIL,61,61,1900,286,599,0.477,111,315,0.352,175,284,0.616,0.57,83,101,0.822,90,235,325,101,37,159,54,150,766,25000000
Robin Lopez,P,35,MIL,16,2,65,7,19,0.368,2,8,0.25,5,11,0.455,0.421,2,2,1.0,3,2,5,4,1,3,2,7,18,3196448
Kevin Love,AP,35,MIA,47,5,822,135,305,0.443,74,212,0.349,61,93,0.656,0.564,81,104,0.779,50,242,292,105,16,9,38,85,425,3835738
Kyle Lowry,BA,37,TOT,44,39,1243,122,286,0.427,73,188,0.388,49,98,0.5,0.554,46,54,0.852,30,122,152,188,46,16,63,109,363,1138964
Trey Lyles,AP,28,SAC,47,0,940,117,257,0.455,69,178,0.388,48,79,0.608,0.589,41,59,0.695,47,163,210,55,13,14,30,75,344,8000000
Théo Maledon,BA,22,TOT,17,1,213,20,70,0.286,5,30,0.167,15,40,0.375,0.321,14,15,0.933,4,20,24,28,7,0,18,21,59,167291
Terance Mann,ES,27,LAC,56,52,1413,176,358,0.492,51,154,0.331,125,204,0.613,0.563,51,64,0.797,69,122,191,99,28,11,35,105,454,10576923
Tre Mann,BA,22,TOT,24,11,454,68,148,0.459,25,61,0.41,43,87,0.494,0.544,16,20,0.8,9,72,81,72,21,0,26,25,177,3191280
Lauri Markkanen,AP,26,UTA,51,51,1677,395,818,0.483,164,409,0.401,231,409,0.565,0.583,222,250,0.888,115,306,421,103,44,24,67,95,1176,17259999
Naji Marshall,AL,26,NOP,51,1,964,131,284,0.461,45,116,0.388,86,168,0.512,0.54,63,80,0.788,48,135,183,103,37,11,56,73,370,1930681
Caleb Martin,AL,28,MIA,46,19,1250,180,398,0.452,61,156,0.391,119,242,0.492,0.529,58,75,0.773,54,157,211,94,32,19,54,101,479,6802950
Cody Martin,AL,28,CHO,28,22,753,82,215,0.381,27,86,0.314,55,129,0.426,0.444,20,33,0.606,19,90,109,104,32,18,44,48,211,7560000
Garrison Mathews,ES,27,ATL,47,4,609,52,120,0.433,47,109,0.431,5,11,0.455,0.629,13,18,0.722,14,50,64,20,11,4,15,76,164,2000000
Bennedict Mathurin,AL,21,IND,59,19,1538,296,663,0.446,80,214,0.374,216,449,0.481,0.507,184,224,0.821,60,174,234,119,35,14,97,117,856,6916080
Wesley Matthews,ES,37,ATL,23,1,250,15,48,0.313,10,37,0.27,5,11,0.455,0.417,14,20,0.7,4,29,33,13,10,6,6,29,54,3196448
Tyrese Maxey,BA,23,PHI,55,55,2056,497,1108,0.449,168,445,0.378,329,663,0.496,0.524,269,309,0.871,31,175,206,345,56,27,94,121,1431,4343920
Skylar Mays,BA,26,TOT,31,5,419,62,156,0.397,16,54,0.296,46,102,0.451,0.449,13,17,0.765,10,32,42,83,17,4,19,25,153,914343
Miles McBride,BA,23,NYK,50,5,741,122,277,0.44,63,155,0.406,59,122,0.484,0.554,23,28,0.821,16,39,55,68,32,5,19,65,330,1836096
T.J. McConnell,BA,31,IND,53,4,929,212,385,0.551,7,24,0.292,205,361,0.568,0.56,37,48,0.771,29,111,140,289,56,5,78,56,468,8700000
Jaden McDaniels,AL,23,MIN,54,53,1577,230,456,0.504,66,183,0.361,164,273,0.601,0.577,42,56,0.75,40,116,156,78,45,30,67,169,568,3901399
Jalen McDaniels,AL,26,TOR,36,0,325,37,110,0.336,11,54,0.204,26,56,0.464,0.386,14,20,0.7,10,42,52,20,13,4,19,33,99,4516000
Doug McDermott,AL,32,TOT,52,0,766,102,239,0.427,80,193,0.415,22,46,0.478,0.594,11,19,0.579,9,42,51,61,11,2,25,51,295,13750000
JaVale McGee,P,36,SAC,39,0,310,73,116,0.629,0,4,0.0,73,112,0.652,0.629,25,43,0.581,37,75,112,14,9,19,31,44,171,3196448
Bryce McGowens,ES,21,CHO,50,13,789,88,194,0.454,30,88,0.341,58,106,0.547,0.531,52,69,0.754,16,75,91,46,20,7,26,70,258,1719864
Jordan McLaughlin,BA,27,MIN,38,0,339,36,85,0.424,21,49,0.429,15,36,0.417,0.547,6,10,0.6,10,29,39,67,26,6,13,21,99,2320000
De'Anthony Melton,ES,25,PHI,36,33,1002,136,348,0.391,75,207,0.362,61,141,0.433,0.499,66,79,0.835,27,110,137,110,56,16,39,82,413,8000000
Nathan Mensah,P,25,CHO,25,0,307,12,28,0.429,0,0,,12,28,0.429,0.429,9,12,0.75,29,36,65,9,6,14,14,64,33,257371
Sam Merrill,ES,27,CLE,45,1,729,118,284,0.415,104,250,0.416,14,34,0.412,0.599,12,13,0.923,18,69,87,67,15,1,12,51,352,1997238
Chimezie Metu,P,26,PHO,37,5,447,66,130,0.508,15,51,0.294,51,79,0.646,0.565,38,43,0.884,24,86,110,19,19,9,27,39,185,2346614
Khris Middleton,AL,32,MIL,43,43,1129,242,497,0.487,73,193,0.378,169,304,0.556,0.56,79,95,0.832,26,158,184,216,38,13,89,104,636,29320988
Brandon Miller,AL,21,CHO,57,51,1828,365,828,0.441,134,359,0.373,231,469,0.493,0.522,101,122,0.828,48,194,242,133,50,31,103,146,965,10880400
Leonard Miller,AL,20,MIN,7,0,26,7,11,0.636,1,3,0.333,6,8,0.75,0.682,0,0,,1,9,10,3,1,1,1,3,15,1800000
Dariq Whitehead,AL,19,BRK,2,0,24,1,5,0.2,0,3,0.0,1,2,0.5,0.2,1,2,0.5,0,4,4,3,0,1,0,0,3,2966040
Patty Mills,BA,35,TOT,20,0,218,24,58,0.414,16,38,0.421,8,20,0.4,0.552,0,0,,5,17,22,14,9,1,9,18,64,6802950
Shake Milton,ES,27,TOT,43,0,555,75,186,0.403,17,62,0.274,58,124,0.468,0.449,38,47,0.809,14,55,69,56,18,6,31,47,205,5000000
Josh Minott,AL,21,MIN,21,0,62,10,21,0.476,1,6,0.167,9,15,0.6,0.5,12,14,0.857,3,9,12,3,3,3,2,7,33,1719864
Davion Mitchell,BA,25,SAC,52,4,700,88,192,0.458,33,96,0.344,55,96,0.573,0.544,20,27,0.741,8,46,54,87,11,3,29,65,229,5063760
Donovan Mitchell,ES,27,CLE,47,47,1679,454,961,0.472,159,428,0.371,295,533,0.553,0.555,248,288,0.861,42,212,254,290,85,24,137,106,1315,32600060
Evan Mobley,AP,22,CLE,38,38,1183,247,427,0.578,11,35,0.314,236,392,0.602,0.591,88,125,0.704,92,296,388,116,34,59,73,108,593,8882760
Malik Monk,ES,25,SAC,61,0,1596,338,753,0.449,136,364,0.374,202,389,0.519,0.539,139,171,0.813,22,156,178,326,39,37,133,124,951,9945830
Moses Moody,ES,21,GSW,49,8,875,148,324,0.457,50,153,0.327,98,171,0.573,0.534,56,71,0.789,54,103,157,37,33,20,35,60,402,3918480
Taze Moore,ES,25,POR,3,0,10,3,5,0.6,0,2,0.0,3,3,1.0,0.6,0,0,,0,0,0,1,1,0,1,2,6,64343
Ja Morant,BA,24,MEM,9,9,318,80,170,0.471,14,51,0.275,66,119,0.555,0.512,52,64,0.813,6,44,50,73,7,5,27,19,226,34005250
Marcus Morris,AP,34,PHI,37,7,637,90,205,0.439,36,90,0.4,54,115,0.47,0.527,31,36,0.861,18,91,109,26,13,11,19,61,247,17116279
Markieff Morris,AP,34,DAL,19,1,163,18,51,0.353,12,32,0.375,6,19,0.316,0.471,3,4,0.75,4,26,30,11,5,1,10,11,51,3196448
Monte Morris,BA,28,TOT,17,0,241,34,90,0.378,11,36,0.306,23,54,0.426,0.439,6,9,0.667,5,24,29,40,8,3,4,6,85,9800926
Trey Murphy III,AL,23,NOP,38,10,1028,172,393,0.438,107,286,0.374,65,107,0.607,0.574,66,87,0.759,25,133,158,70,33,20,16,47,517,3359280
Dejounte Murray,ES,27,ATL,60,60,2109,503,1076,0.467,137,381,0.36,366,695,0.527,0.531,166,205,0.81,43,276,319,343,78,19,138,100,1309,18214000
Jamal Murray,BA,26,DEN,48,48,1526,384,799,0.481,117,277,0.422,267,522,0.511,0.554,126,148,0.851,32,159,191,313,42,30,103,87,1011,33833400
Keegan Murray,AL,23,SAC,58,58,1909,325,701,0.464,127,353,0.36,198,348,0.569,0.554,77,93,0.828,72,230,302,95,62,40,50,158,854,8409000
Kris Murray,AL,23,POR,43,10,723,77,192,0.401,25,95,0.263,52,97,0.536,0.466,19,31,0.613,41,76,117,48,35,9,29,49,198,2847480
Mike Muscala,P,32,TOT,38,6,520,50,139,0.36,28,88,0.318,22,51,0.431,0.46,17,24,0.708,32,75,107,32,8,12,18,44,145,808297
Svi Mykhailiuk,AL,26,BOS,26,0,206,26,74,0.351,19,59,0.322,7,15,0.467,0.48,3,6,0.5,8,18,26,14,8,0,8,12,74,2346614
Andrew Nembhard,BA,24,IND,50,29,1187,192,388,0.495,42,116,0.362,150,272,0.551,0.549,30,38,0.789,30,70,100,214,49,4,83,99,456,2131905
Aaron Nesmith,AL,24,IND,55,30,1481,242,478,0.506,112,252,0.444,130,226,0.575,0.623,75,105,0.714,48,159,207,80,55,36,52,181,671,5634257
Georges Niang,AP,30,CLE,63,3,1362,204,467,0.437,107,292,0.366,97,175,0.554,0.551,37,45,0.822,19,205,224,78,18,14,50,144,552,8800000
Zeke Nnaji,AP,23,DEN,49,0,482,56,130,0.431,5,21,0.238,51,109,0.468,0.45,42,59,0.712,56,51,107,28,13,33,27,70,159,4306281
Jaylen Nowell,ES,24,MEM,9,1,156,22,55,0.4,4,23,0.174,18,32,0.563,0.436,3,3,1.0,3,11,14,16,3,0,5,13,51,248850
Frank Ntilikina,BA,25,CHO,5,0,43,1,9,0.111,1,8,0.125,0,1,0.0,0.167,2,2,1.0,1,5,6,4,0,0,1,4,5,2528233
Jordan Nwora,AL,25,TOT,35,1,380,70,165,0.424,23,73,0.315,47,92,0.511,0.494,29,33,0.879,17,54,71,37,13,4,20,35,192,3200000
Royce O'Neale,AL,30,TOT,61,12,1556,165,429,0.385,126,342,0.368,39,87,0.448,0.531,21,31,0.677,48,247,295,180,49,37,59,145,477,9500000
Chuma Okeke,AL,25,ORL,38,8,395,39,104,0.375,23,76,0.303,16,28,0.571,0.486,2,5,0.4,18,56,74,18,8,7,12,19,103,5266713
Josh Okogie,ES,25,PHO,54,11,926,83,199,0.417,27,91,0.297,56,108,0.519,0.485,74,100,0.74,71,77,148,62,47,22,33,65,267,2815937
Onyeka Okongwu,P,23,ATL,53,8,1367,214,351,0.61,22,65,0.338,192,286,0.671,0.641,92,115,0.8,143,226,369,71,23,59,45,158,542,8109063
Isaac Okoro,AL,23,CLE,54,31,1448,190,378,0.503,66,164,0.402,124,214,0.579,0.59,77,112,0.688,56,109,165,109,47,30,41,108,523,8920795
Kelly Olynyk,P,32,TOT,62,11,1294,187,349,0.536,46,116,0.397,141,233,0.605,0.602,110,131,0.84,81,227,308,262,57,21,100,169,530,12195122
Eugene Omoruyi,AL,26,WAS,31,0,233,53,109,0.486,6,27,0.222,47,82,0.573,0.514,24,33,0.727,26,37,63,23,19,1,15,43,136,940566
Cedi Osman,AL,28,SAS,63,1,1099,158,333,0.474,71,190,0.374,87,143,0.608,0.581,34,50,0.68,23,134,157,107,33,9,42,92,421,6718842
Chris Paul,BA,38,GSW,39,12,1048,128,297,0.431,56,148,0.378,72,149,0.483,0.525,40,48,0.833,12,134,146,277,52,3,46,66,352,30800000
Cameron Payne,BA,29,TOT,59,5,948,149,335,0.445,71,186,0.382,78,149,0.523,0.551,53,61,0.869,12,70,82,148,28,5,43,92,422,2891467
Gary Payton II,ES,31,GSW,28,0,435,68,127,0.535,14,40,0.35,54,87,0.621,0.591,9,14,0.643,34,49,83,27,29,10,17,45,159,8715000
Julian Phillips,AL,20,CHI,38,0,283,29,68,0.426,10,34,0.294,19,34,0.559,0.5,10,16,0.625,10,22,32,13,5,6,9,38,78,1600000
Jalen Pickett,ES,24,DEN,21,0,108,12,30,0.4,7,22,0.318,5,8,0.625,0.517,3,4,0.75,1,10,11,15,3,0,8,11,34,1708143
Mason Plumlee,P,33,LAC,28,9,477,65,100,0.65,0,0,,65,100,0.65,0.65,48,72,0.667,42,122,164,33,10,12,21,46,178,5000000
Brandin Podziemski,ES,20,GSW,55,22,1476,209,464,0.45,68,183,0.372,141,281,0.502,0.524,43,70,0.614,86,231,317,216,46,11,69,95,529,3352440
Jakob Poeltl,P,28,TOR,50,50,1319,248,378,0.656,0,0,,248,378,0.656,0.656,59,107,0.551,146,283,429,127,35,76,77,149,555,19500000
Aleksej Pokusevski,AP,22,TOT,11,0,68,6,18,0.333,3,12,0.25,3,6,0.5,0.417,4,6,0.667,2,10,12,5,2,2,4,5,19,565176
Jordan Poole,ES,24,WAS,61,52,1795,365,899,0.406,132,419,0.315,233,480,0.485,0.479,156,181,0.862,23,133,156,231,68,23,139,199,1018,28705357
Craig Porter Jr.,BA,23,CLE,39,5,522,95,187,0.508,7,23,0.304,88,164,0.537,0.527,35,49,0.714,18,72,90,98,19,12,36,34,232,1866574
Michael Porter Jr.,AL,25,DEN,63,63,1997,403,836,0.482,173,436,0.397,230,400,0.575,0.586,64,78,0.821,83,359,442,93,31,45,71,121,1043,33386850
Bobby Portis,AP,28,MIL,64,1,1537,344,687,0.501,75,198,0.379,269,489,0.55,0.555,85,107,0.794,103,351,454,75,47,24,64,153,848,11710818
Dwight Powell,P,32,DAL,52,8,748,68,97,0.701,1,2,0.5,67,95,0.705,0.706,61,84,0.726,82,102,184,76,23,19,29,104,198,4000000
Norman Powell,ES,30,LAC,61,1,1574,297,606,0.49,135,303,0.446,162,303,0.535,0.601,104,126,0.825,12,146,158,63,35,20,54,110,833,18000000
Taurean Prince,AP,29,LAL,62,49,1771,206,472,0.436,118,302,0.391,88,170,0.518,0.561,38,53,0.717,15,170,185,102,49,29,56,127,568,4516000
Payton Pritchard,BA,26,BOS,63,0,1278,183,412,0.444,105,275,0.382,78,137,0.569,0.572,30,37,0.811,54,142,196,166,28,6,41,79,501,4037278
Neemias Queta,P,24,BOS,23,0,283,49,80,0.613,0,0,,49,80,0.613,0.613,15,20,0.75,44,58,102,11,10,14,9,45,113,250000
Immanuel Quickley,ES,24,TOT,59,29,1691,332,760,0.437,150,369,0.407,182,391,0.465,0.536,156,186,0.839,14,197,211,263,40,8,79,96,970,4171548
Julius Randle,AP,29,NYK,46,46,1630,395,836,0.472,76,244,0.311,319,592,0.539,0.518,236,302,0.781,99,324,423,229,25,12,159,125,1102,25660800
Duop Reath,P,27,POR,49,16,897,172,362,0.475,68,182,0.374,104,180,0.578,0.569,52,73,0.712,75,113,188,53,25,29,40,126,464,2324408
Austin Reaves,ES,25,LAL,65,40,2052,360,729,0.494,117,312,0.375,243,417,0.583,0.574,185,215,0.86,43,220,263,362,57,14,139,119,1022,12015150
Cam Reddish,AL,24,LAL,40,26,886,88,217,0.406,35,102,0.343,53,115,0.461,0.486,37,48,0.771,22,69,91,47,45,12,31,59,248,2165000
Paul Reed,P,24,PHI,63,23,1171,194,358,0.542,16,42,0.381,178,316,0.563,0.564,38,51,0.745,144,215,359,81,44,57,44,153,442,7723000
Naz Reid,P,24,MIN,64,0,1484,301,624,0.482,124,298,0.416,177,326,0.543,0.582,82,108,0.759,62,251,313,71,44,52,79,130,808,12950400
Nick Richards,P,26,CHO,54,41,1419,212,307,0.691,0,1,0.0,212,306,0.693,0.691,114,155,0.735,146,291,437,43,21,68,60,144,538,5000000
Josh Richardson,ES,30,MIA,43,6,1103,154,347,0.444,66,190,0.347,88,157,0.561,0.539,51,54,0.944,18,103,121,105,24,14,36,76,425,2891467
Duncan Robinson,AL,29,MIA,58,26,1639,269,587,0.458,165,403,0.409,104,184,0.565,0.599,72,81,0.889,12,132,144,173,39,14,78,137,775,18154000
Mitchell Robinson,P,25,NYK,21,21,613,58,98,0.592,0,0,,58,98,0.592,0.592,14,38,0.368,112,104,216,15,32,27,21,40,130,15681818
Orlando Robinson,P,23,MIA,27,7,273,33,67,0.493,7,14,0.5,26,53,0.491,0.545,18,24,0.75,23,55,78,29,7,7,17,35,91,1801769
David Roddy,AP,22,TOT,55,13,1146,159,396,0.402,48,162,0.296,111,234,0.474,0.462,47,68,0.691,52,151,203,76,25,11,55,70,413,2718240
Ryan Rollins,BA,21,WAS,10,0,66,13,25,0.52,2,3,0.667,11,22,0.5,0.56,13,17,0.765,2,9,11,11,8,3,7,7,41,1719864
Derrick Rose,BA,35,MEM,24,7,399,76,165,0.461,15,41,0.366,61,124,0.492,0.506,24,27,0.889,7,38,45,78,8,2,31,21,191,3196448
Terry Rozier,ES,29,TOT,46,45,1564,339,763,0.444,108,312,0.346,231,451,0.512,0.515,146,168,0.869,29,157,186,292,45,16,87,82,932,23205221
Rayan Rupert,ES,19,POR,22,0,209,23,63,0.365,12,29,0.414,11,34,0.324,0.46,7,10,0.7,13,23,36,20,5,0,11,19,65,1119563
D'Angelo Russell,BA,27,LAL,60,53,1914,398,844,0.472,171,403,0.424,227,441,0.515,0.573,120,149,0.805,23,155,178,374,51,30,119,128,1087,17307693
Domantas Sabonis,P,27,SAC,62,62,2218,503,825,0.61,29,69,0.42,474,756,0.627,0.627,205,296,0.693,217,621,838,523,55,34,202,193,1240,30600000
Gui Santos,AP,21,GSW,17,0,147,19,39,0.487,7,18,0.389,12,21,0.571,0.577,14,15,0.933,15,29,44,11,3,2,7,17,59,1029483
Marcus Sasser,BA,23,DET,54,0,876,151,333,0.453,61,154,0.396,90,179,0.503,0.545,35,41,0.854,7,78,85,161,32,8,55,76,398,2624040
Dennis Schröder,BA,30,TOT,64,42,1948,318,715,0.445,108,284,0.38,210,431,0.487,0.52,141,173,0.815,27,151,178,387,51,11,113,130,885,12405000
Alperen Sengun,P,21,HOU,62,62,2016,520,968,0.537,33,111,0.297,487,857,0.568,0.554,244,350,0.697,183,400,583,310,74,46,162,207,1317,3536400
Brice Sensabaugh,AL,20,UTA,14,2,171,27,58,0.466,10,29,0.345,17,29,0.586,0.552,8,9,0.889,5,20,25,10,4,0,16,14,72,2448600
Collin Sexton,ES,25,UTA,64,41,1626,392,812,0.483,107,265,0.404,285,547,0.521,0.549,272,316,0.861,53,108,161,300,51,13,123,125,1163,17325000
Landry Shamet,ES,26,WAS,45,5,719,118,274,0.431,53,157,0.338,65,117,0.556,0.527,38,46,0.826,16,46,62,54,25,10,30,75,327,10250000
Day'Ron Sharpe,P,22,BRK,47,1,729,135,233,0.579,4,12,0.333,131,221,0.593,0.588,65,106,0.613,126,186,312,68,21,35,50,103,339,2210160
Shaedon Sharpe,ES,20,POR,32,25,1059,176,434,0.406,60,180,0.333,116,254,0.457,0.475,98,119,0.824,42,118,160,94,28,12,72,88,510,6313800
Ben Sheppard,ES,22,IND,39,0,468,56,133,0.421,34,91,0.374,22,42,0.524,0.549,14,17,0.824,8,50,58,29,21,2,7,59,160,2537160
Pascal Siakam,AP,29,TOT,62,62,2107,522,979,0.533,73,215,0.34,449,764,0.588,0.57,222,300,0.74,99,308,407,289,49,18,117,147,1339,37893408
Ben Simmons,BA,27,BRK,15,12,359,43,74,0.581,0,0,,43,74,0.581,0.581,6,15,0.4,31,88,119,86,12,9,27,36,92,37893408
Anfernee Simons,ES,24,POR,40,40,1380,318,737,0.431,136,350,0.389,182,387,0.47,0.524,142,156,0.91,20,125,145,220,21,4,115,88,914,24107143
Jericho Sims,P,25,NYK,36,10,488,36,48,0.75,0,0,,36,48,0.75,0.75,13,20,0.65,50,72,122,22,5,16,12,35,85,1927896
Dmytro Skapintsev,P,25,NYK,2,0,2,0,1,0.0,0,0,,0,1,0.0,0.0,0,0,,0,0,0,0,0,0,0,0,0,35389
Javonte Smart,BA,24,PHI,1,0,1,0,0,,0,0,,0,0,,,0,0,,0,0,0,0,0,0,0,0,0,196245
Marcus Smart,BA,29,MEM,20,20,605,102,237,0.43,42,134,0.313,60,103,0.583,0.519,43,56,0.768,6,47,53,86,41,5,62,53,289,18583713
Dennis Smith Jr.,BA,26,BRK,48,2,945,131,308,0.425,26,95,0.274,105,213,0.493,0.468,40,54,0.741,45,107,152,183,58,12,59,109,328,2528233
Dru Smith,ES,26,MIA,9,0,131,15,33,0.455,7,17,0.412,8,16,0.5,0.561,2,2,1.0,6,8,14,14,9,3,5,12,39,1801769
Ish Smith,BA,35,CHO,43,5,741,66,158,0.418,4,8,0.5,62,150,0.413,0.43,3,4,0.75,11,65,76,145,17,4,47,49,139,3196448
Jabari Smith Jr.,AP,20,HOU,58,58,1861,282,627,0.45,100,279,0.358,182,348,0.523,0.53,111,137,0.81,116,379,495,87,41,45,69,156,775,9326520
Jalen Smith,P,23,IND,45,13,799,183,296,0.618,48,107,0.449,135,189,0.714,0.699,53,78,0.679,74,173,247,49,11,28,37,95,467,5043773
Nick Smith Jr.,ES,19,CHO,39,0,605,90,227,0.396,51,116,0.44,39,111,0.351,0.509,11,13,0.846,17,39,56,50,8,7,32,50,242,2463960
Jeremy Sochan,AP,20,SAS,64,63,1892,289,655,0.441,60,183,0.328,229,472,0.485,0.487,97,125,0.776,116,280,396,216,48,30,120,152,735,5316960
Jaden Springer,ES,21,TOT,38,1,397,48,126,0.381,8,39,0.205,40,87,0.46,0.413,28,34,0.824,28,34,62,36,25,11,27,52,132,2226360
Lamar Stevens,AP,26,TOT,30,2,352,72,148,0.486,9,23,0.391,63,125,0.504,0.517,26,35,0.743,25,62,87,16,12,16,20,34,179,2092354
Isaiah Stewart,AP,22,DET,41,40,1266,166,349,0.476,58,156,0.372,108,193,0.56,0.559,59,79,0.747,70,210,280,68,17,32,63,93,449,5266713
Julian Strawther,AL,21,DEN,40,0,497,75,200,0.375,38,125,0.304,37,75,0.493,0.47,18,25,0.72,4,48,52,42,17,7,17,49,206,2431080
Max Strus,AL,27,CLE,60,60,1932,263,638,0.412,144,423,0.34,119,215,0.553,0.525,62,79,0.785,53,231,284,230,53,28,91,153,732,14487684
Jalen Suggs,ES,22,ORL,58,58,1543,255,554,0.46,119,303,0.393,136,251,0.542,0.568,81,107,0.757,40,149,189,149,81,34,111,165,710,7252200
Jae'Sean Tate,AL,28,HOU,54,9,910,93,198,0.47,21,69,0.304,72,129,0.558,0.523,22,32,0.688,53,122,175,57,38,10,28,122,229,6500000
Jayson Tatum,AP,25,BOS,60,60,2154,548,1158,0.473,188,500,0.376,360,658,0.547,0.554,329,397,0.829,53,454,507,293,61,34,153,122,1613,32600060
Terry Taylor,AP,24,CHI,24,0,161,17,34,0.5,2,9,0.222,15,25,0.6,0.529,2,3,0.667,15,18,33,7,4,2,7,16,38,2019706
Garrett Temple,ES,37,TOR,16,0,69,8,21,0.381,2,9,0.222,6,12,0.5,0.429,5,6,0.833,5,6,11,6,3,0,5,6,23,3196448
Dalen Terry,ES,21,CHI,41,1,405,33,84,0.393,11,46,0.239,22,38,0.579,0.458,18,28,0.643,15,52,67,50,15,8,19,52,95,3350760
Daniel Theis,P,31,TOT,47,3,811,124,234,0.53,19,52,0.365,105,182,0.577,0.571,31,43,0.721,69,116,185,48,18,39,33,108,298,2179511
Cam Thomas,ES,22,BRK,49,34,1461,374,852,0.439,101,277,0.365,273,575,0.475,0.498,185,221,0.837,18,121,139,130,36,12,87,101,1034,2240040
Amen Thompson,AL,21,HOU,44,6,865,138,275,0.502,7,50,0.14,131,225,0.582,0.515,60,93,0.645,79,169,248,102,54,31,62,101,343,8809320
Ausar Thompson,AL,21,DET,63,38,1583,232,480,0.483,21,113,0.186,211,367,0.575,0.505,71,119,0.597,129,273,402,120,68,59,84,175,556,7977480
Klay Thompson,AL,33,GSW,60,51,1779,363,858,0.423,199,522,0.381,164,336,0.488,0.539,103,112,0.92,27,178,205,131,35,28,90,108,1028,43219440
Tristan Thompson,P,32,CLE,36,0,446,61,94,0.649,0,1,0.0,61,93,0.656,0.649,13,42,0.31,59,81,140,40,8,11,23,50,135,3196448
Matisse Thybulle,AL,26,POR,60,19,1401,119,299,0.398,76,218,0.349,43,81,0.531,0.525,22,29,0.759,29,96,125,80,108,44,37,90,336,10500000
Jacob Toppin,AL,23,NYK,9,0,38,5,9,0.556,1,4,0.25,4,5,0.8,0.611,2,2,1.0,3,4,7,3,0,1,1,3,13,453617
Obi Toppin,AP,25,IND,64,28,1400,258,459,0.562,80,200,0.4,178,259,0.687,0.649,61,81,0.753,66,178,244,96,33,33,55,115,657,6803012
Karl-Anthony Towns,AP,28,MIN,60,60,1969,472,932,0.506,134,317,0.423,338,615,0.55,0.578,250,286,0.874,91,413,504,179,43,40,169,198,1328,36016200
Gary Trent Jr.,ES,25,TOR,59,29,1613,270,643,0.42,145,361,0.402,125,282,0.443,0.533,43,61,0.705,19,125,144,88,58,9,39,74,728,18785000
P.J. Tucker,AP,38,TOT,18,3,269,6,20,0.3,5,16,0.313,1,4,0.25,0.425,3,3,1.0,17,31,48,8,9,3,5,38,20,11014500
Myles Turner,P,27,IND,60,60,1633,372,712,0.522,81,244,0.332,291,468,0.622,0.579,205,261,0.785,97,328,425,76,33,105,89,190,1030,20975000
Hunter Tyson,AP,23,DEN,11,0,32,3,11,0.273,2,9,0.222,1,2,0.5,0.364,0,0,,1,8,9,1,0,0,2,7,8,1119563
Stanley Umude,ES,24,DET,18,0,204,26,57,0.456,18,34,0.529,8,23,0.348,0.614,22,24,0.917,6,27,33,9,4,6,11,31,92,934168
Jarred Vanderbilt,AP,24,LAL,29,6,581,59,114,0.518,8,27,0.296,51,87,0.586,0.553,24,36,0.667,41,97,138,36,36,5,28,43,150,4698000
Fred VanVleet,BA,29,HOU,56,56,2059,309,756,0.409,169,443,0.381,140,313,0.447,0.521,142,166,0.855,23,185,208,448,66,47,92,128,929,40806300
Devin Vassell,ES,23,SAS,58,52,1876,421,893,0.471,145,385,0.377,276,508,0.543,0.553,143,180,0.794,27,201,228,230,61,22,90,58,1130,5887899
Sasha Vezenkov,AP,28,SAC,35,0,440,74,165,0.448,38,100,0.38,36,65,0.554,0.564,10,13,0.769,30,56,86,15,16,7,11,35,196,6341464
Gabe Vincent,BA,27,LAL,5,0,127,12,32,0.375,2,17,0.118,10,15,0.667,0.406,1,2,0.5,2,3,5,15,6,0,2,12,27,10500000
Dean Wade,AP,27,CLE,54,32,1108,96,232,0.414,79,202,0.391,17,30,0.567,0.584,20,26,0.769,37,181,218,43,40,25,20,93,291,5709877
Franz Wagner,AL,22,ORL,56,56,1855,423,885,0.478,83,278,0.299,340,607,0.56,0.525,206,243,0.848,56,253,309,219,57,24,117,128,1135,5508720
Moritz Wagner,P,26,ORL,62,1,1138,263,441,0.596,29,89,0.326,234,352,0.665,0.629,140,173,0.809,96,186,282,74,31,18,75,131,695,8000000
Ish Wainright,AL,29,POR,7,0,46,6,18,0.333,6,16,0.375,0,2,0.0,0.5,2,2,1.0,0,9,9,0,2,1,1,4,20,853149
Jabari Walker,AL,21,POR,57,15,1260,179,382,0.469,28,106,0.264,151,276,0.547,0.505,96,125,0.768,116,252,368,50,35,21,53,133,482,1719864
Jarace Walker,AP,20,IND,22,0,224,32,80,0.4,15,39,0.385,17,41,0.415,0.494,6,7,0.857,9,34,43,28,13,9,12,21,85,6059520
Cason Wallace,ES,20,OKC,63,9,1281,160,321,0.498,72,176,0.409,88,145,0.607,0.611,23,29,0.793,40,101,141,84,49,27,30,98,415,5291400
Jordan Walsh,AL,19,BOS,4,0,33,1,5,0.2,0,3,0.0,1,2,0.5,0.2,0,0,,2,9,11,2,2,1,2,5,2,1119563
P.J. Washington,AP,25,TOT,56,28,1668,280,630,0.444,99,311,0.318,181,319,0.567,0.523,82,115,0.713,68,228,296,114,50,41,81,134,741,16847826
Yuta Watanabe,AL,29,TOT,34,0,464,41,116,0.353,25,85,0.294,16,31,0.516,0.461,10,17,0.588,11,43,54,15,12,7,19,39,117,2346614
Trendon Watford,AP,23,BRK,46,0,536,103,197,0.523,15,42,0.357,88,155,0.568,0.561,45,51,0.882,39,84,123,55,15,12,34,73,266,2019706
Peyton Watson,AL,21,DEN,62,4,1138,163,348,0.468,41,130,0.315,122,218,0.56,0.527,59,85,0.694,40,141,181,63,35,62,46,105,426,2303520
Victor Wembanyama,P,20,SAS,56,56,1610,423,901,0.469,94,281,0.335,329,620,0.531,0.522,220,270,0.815,121,453,574,192,72,193,194,123,1160,12160680
Blake Wesley,ES,20,SAS,43,1,573,69,136,0.507,5,32,0.156,64,104,0.615,0.526,32,50,0.64,11,43,54,118,22,7,34,66,175,2504640
Russell Westbrook,BA,35,LAC,58,10,1313,257,569,0.452,37,138,0.268,220,431,0.51,0.484,90,133,0.677,80,214,294,256,65,21,118,103,641,3835738
Coby White,BA,23,CHI,64,64,2361,447,980,0.456,184,471,0.391,263,509,0.517,0.55,182,217,0.839,35,270,305,340,45,15,142,152,1260,12444444
Derrick White,ES,29,BOS,59,59,1900,311,662,0.47,151,380,0.397,160,282,0.567,0.584,115,128,0.898,40,197,237,296,60,73,94,122,888,18107143
Cam Whitmore,AL,19,HOU,37,1,658,166,356,0.466,59,164,0.36,107,192,0.557,0.549,59,88,0.67,33,110,143,18,23,11,36,49,450,3218160
Aaron Wiggins,ES,25,OKC,60,0,878,145,254,0.571,47,95,0.495,98,159,0.616,0.663,36,46,0.783,46,95,141,52,34,12,36,70,373,1836096
Andrew Wiggins,AL,28,GSW,54,42,1443,258,570,0.453,61,175,0.349,197,395,0.499,0.506,95,130,0.731,81,146,227,93,32,27,64,118,672,24330357
Lindell Wigginton,BA,25,MIL,3,0,8,2,5,0.4,0,2,0.0,2,3,0.667,0.4,2,2,1.0,0,0,0,0,0,0,1,1,6,244502
Grant Williams,AP,25,TOT,60,36,1643,188,435,0.432,99,266,0.372,89,169,0.527,0.546,72,96,0.75,66,172,238,113,33,33,78,176,547,12405000
Jalen Williams,AP,22,OKC,57,57,1820,429,796,0.539,87,193,0.451,342,603,0.567,0.594,152,186,0.817,30,201,231,257,61,30,98,152,1097,4558680
Jaylin Williams,P,21,OKC,51,0,645,67,168,0.399,39,106,0.368,28,62,0.452,0.515,23,28,0.821,29,139,168,67,21,19,20,73,196,2000000
Kenrich Williams,AP,29,OKC,51,1,726,84,187,0.449,39,101,0.386,45,86,0.523,0.553,3,10,0.3,37,104,141,62,25,6,20,69,210,6175000
Mark Williams,P,22,CHO,19,19,508,98,151,0.649,0,0,,98,151,0.649,0.649,46,64,0.719,76,108,184,22,16,20,17,50,242,3908160
Patrick Williams,AP,22,CHI,43,30,1174,159,359,0.443,59,148,0.399,100,211,0.474,0.525,52,66,0.788,46,120,166,66,40,33,57,87,429,9835881
Robert Williams,P,26,POR,6,0,119,17,26,0.654,0,0,,17,26,0.654,0.654,7,9,0.778,11,27,38,5,7,7,7,17,41,11812501
Vince Williams Jr.,ES,23,MEM,52,33,1436,169,379,0.446,79,209,0.378,90,170,0.529,0.55,104,130,0.8,59,231,290,175,47,34,92,135,521,2486462
Ziaire Williams,AL,22,MEM,51,15,1038,150,378,0.397,58,189,0.307,92,189,0.487,0.474,62,75,0.827,35,145,180,75,36,9,66,85,420,4810200
Zion Williamson,AP,23,NOP,52,52,1591,451,785,0.575,5,14,0.357,446,771,0.578,0.578,239,344,0.695,91,202,293,268,47,31,132,118,1146,34005250
Jalen Wilson,AP,23,BRK,26,1,374,41,99,0.414,15,42,0.357,26,57,0.456,0.49,21,23,0.913,31,39,70,29,7,1,9,30,118,707770
James Wiseman,P,22,DET,44,0,647,119,178,0.669,0,2,0.0,119,176,0.676,0.669,34,55,0.618,69,122,191,32,8,26,37,96,272,12119440
Christian Wood,AP,28,LAL,50,1,872,123,264,0.466,35,114,0.307,88,150,0.587,0.532,66,94,0.702,39,215,254,49,16,33,50,72,347,2709849
Delon Wright,BA,31,TOT,36,1,512,52,131,0.397,16,42,0.381,36,89,0.404,0.458,29,35,0.829,14,49,63,91,38,9,11,23,149,947205
Thaddeus Young,AP,35,TOT,25,6,379,57,93,0.613,1,6,0.167,56,87,0.644,0.618,5,14,0.357,36,49,85,50,19,3,12,42,120,1010371
Trae Young,BA,25,ATL,51,51,1862,418,982,0.426,169,456,0.371,249,526,0.473,0.512,339,396,0.856,22,118,140,553,70,11,220,106,1344,40064220
Omer Yurtseven,P,25,UTA,35,6,317,49,94,0.521,4,17,0.235,45,77,0.584,0.543,8,15,0.533,45,81,126,16,5,14,25,39,110,2800000
Cody Zeller,P,31,NOP,39,0,301,25,60,0.417,1,3,0.333,24,57,0.421,0.425,22,36,0.611,46,61,107,36,8,5,15,42,73,3196448
Ivica Zubac,P,26,LAC,50,50,1311,246,378,0.651,0,0,,246,378,0.651,0.651,85,126,0.675,148,314,462,68,11,61,59,137,577,10933333
